--------ESPAGNOL -> FRANÇAIS--------------

A
abanicar     = éventer
abarrotado,a = plein à craquer, bondé
abarrotar    = remplir
abarrote     = ballot, épicerie (amérique)
abastecer    = approvisionner, ravitailler
abigar       = ?
abofetear    = gifler
abrazador    = brulant, accablant
abrazar      = serrer dans ses bras
               épouser, entrer dans
abrehuecos   = ?
abrigar      = couvrir, nourrir
abrigo       = manteau, abri
abrillantar  = faire briller
               mettre à son avantage
abrumador    = accablant, épuisant
aburrir/se   = ennuyer, s'ennuyer
acá          = ici
acabar       = finir, achever
               terminer épuiser
acaecer      = avoir lieu, arriver
acaloradamente = ?
acalorar     = donner chaud, échauffer
acariciar    = caresser
acaso        = peut-être
acatar       = observer, respecter
acechar      = guetter
acecho       = guet, affût
acera        = trottoir
acero        = acier
acertar      = atteindre
               mettre dans le mille
               deviner, trouver
               bien choisir, bien faire
               réussir
achicar      = rétrécir, écoper, drainer
               intimider
acobardar    = faire peur à, décourager
acobardarse  = se dérober, se dégonfler
acoger       = recevoir, accueillir
acogerse     = se retrancher derrière
               recourir à
acomodar     = faire asseoir, installer
               placer, ajuster, aménager
acomodaticio,a = accomodant
aconsejar    = conseiller, recommander
aconsejarse  = demander conseil à
               se faire conseiller par
acontecimiento = évènement, fait
acopio       = surabondance
acordar      = décider, convenir de
               se mettre d'accord sur
acordarse    = se souvenir de, se rappeler
               penser à
acosar       = traquer, harceler
acoso        = poursuite, harcèlement
acostar(se)  = coucher, se coucher
acrata       = anarchiste
actitud      = attitude, comportement
               conduite
activo       = actif
acudir       = faire appel à
               avoir recours à, venir
               revenir, se présenter
acuñar       = frapper, bercer
adecentar    = nettoyer, mettre en ordre
adelantar    = avancer, dépasser, doubler
adelgazar    = maigrir, perdre
ademán       = geste, manières, façons
adherir      = coller, fixer
adiestrar    = dresser, entraîner, exercer
adiposo      = adipeux
adornar      = décorer, orner
adscribir    = attribuer, fixer, rattacher
aducir       = alléguer
adujo        = aducir (3e pers. sing. pret. ind.)
advertencia  = avertissement
advertir     = avertir, prévenir
               remarquer, constater
               se rendre compte
afán         = ardeur, soif
               désir véhément, efforts
afeitar      = raser
aferrar      = accrocher ?
afianzar     = consolider, renforcer
aficion      = penchant, goût, amateur de
               supporters, fans, amateurs
afilado      = effilé, aiguisé, taillé
               incisif, affûtage
afinar       = accorder, poser, peaufiner
               ajuster, affiner
afin(es)     = voisin(s), commun
               similaire
aflojar      = desserrer, donner du mou
               filer, baisser, tomber
               se calmer
afrancesado  = très français
agárrar      = saisir, attraper, prendre
agasajar     = recevoir chaleureusement
               bien accueillir, fêter
agasajo      = festin, banquet
agazapar     = cacher
agilizar     = faciliter
aglutinar    = agglutiner, regrouper
               conjuguer, rassembler
agorero,a    = augure, devin, prophète
               de mauvais augure
agotado      = épuisé
agradar      = être agréable, plaire
agradecer    = remercier, apprécier
agradecido   = reconnaissant
agrado       = plaisir, complaisance
agredir      = agresser, attaquer
agregar      = ajouter
agregarse    = rejoindre
agreste      = sauvage, agreste (rustique)
agridulce    = aigre-doux
aguacate     = avocat(fruit), avocatier
aguacero     = averse
aguachirle   = lavasse (café)
aguada       = gouache
aguado,a     = coupé, trop liquide, gaché
aguantar     = tenir, supporter, souffrir
               retenir, résister
aguanté      = patience, résistance
               endurance
aguardar     = être dans l'attente de
               attendre
agudo,a      = pointu, aigu, grave, fort
               vif, fin, perçant
               spirituel
aguerrido,a  = agguerri(e), chevronné(e)
aguijón      = dard, épine, motivation
aguijonazo   = ?
aguijonear   = aiguillonner, titiller
aguja        = aiguille, aiguillette
               aiguillage
agujerear    = percer, faire des trous
agujero      = trou
aguzar       = aiguiser, affiler, affiner
ahí          = là
ahijado,a    = filleul, protégé
ahogar       = noyer, étouffer, étrangler
ahorita, ahoritita = tout de suite
ahorrar      = économiser, épargner
ahuyentar    = faire fuir, chasser
airado       = irrité
aislado      = isolé
aislar       = isoler
ajedrez      = échecs
ajeno        = contraire, étranger
ajillo (al)  = avec une sauce à base d'huile
               ail et piment
ajo          = ail
ajo (estar en el ajo) = être dans le coup
ajustador    = pieza ajustadora = pièce manquante
               typographe
ajuste       = ajustage, façonnage
               réglage
alamar       = brandebourg, frange
alamares     = ?
alargar      = allonger, rallonger
               prolonger, passer
alarido      = hurlement
albergar     = héberger, loger, nourrir
albergue     = hébergement, refuge
alborozar    = transporter de joie
alborozo     = débordement de joie
alcaide      = directeur de prison
alcance      = portée
alcantarilla = égout
alcanzar     = atteindre, rattraper
               passer, obtenir
alce         = élan
               alcé         --> alzar
alcoba       = chambre, alcôve, boudoir
               voiture-couchette
               voiture-lit
alcolifán    = ?
alcurnia (de) = de haute lignée
alejar(se)   = éloigner (s')
alentar      = encourager
alevosía     = traitrise
alevoso/a    = prémédité, traitre
               traitresse, fourbe
alfombra     = tapis
algarada     = razzia, incursion, brouhaha
aliento      = haleine, d'une seule traite
               courage
alimaña      = animal nuisible
aliñar       = assaisonner
aliño        = assaisonnement
aliviar      = calmer, atténuer, apaiser
               alléger
aljibe       = citerne, bateau-citerne
allegado     = proche
almacén      = magasin
almendro     = amandier
almíbar      = sirop
almibarada   = mielleuse
almorzar     = déjeuner, prendre un en-cas
almuerzo     = déjeuner
alojar       = loger
altanero,a   = hautain
altura       = hauteur, haut, altitude
               niveau
altura (a estas) = date (à cette)
               heure actuelle (à l')
alucinar     = délirer, rêver, halluciner
               épater
alud         = avalanche (literal & figurado)
aludir       = faire allusion à, évoquer
alumbrar     = éclairer, allumer
               mettre bas, enfanter
               concevoir
alzar        = lever, élever, hausser
               relever, soulever
amable       = aimable
amago        = signe avant-coureur, menace
amainar      = amener, se calmer, faiblir
               passer
amanecer     = lever du jour
               commencer à faire jour
amargo       = amer
amasar       = pétrir, gâcher (platre)
               masser
amenazar     = menacer
ametralladora = mitrailleuse
amoldar      = adapter
amontonar    = entasser, accumuler
               amasser
anaranjado,a = orangé
ancho        = largeur
ancho,a      = large
anclado      = ancré
anclaje      = ancrage, mouillage
andadera     = trotteur (pour marcher)
andar        = marcher, parcourir
andrajo      = guenilles, loques
anegar       = noyer, inonder
angosto      = étroit
anilla       = anneau, anneaux
anillar      = anneler, garnir d'anneaux
aniquilar    = anéantir, exterminer
anjá         = ?
anómalo,a    = anormal
antesala     = hall, antichambre
anticipar    = avancer, anticiper
añagaza      = appeau, artifice, leure
añoranza     = nostalgie, regret
               mal du pays
apacible     = pasible, doux
apaciguar    = apaiser
apagar       = éteindre, calmer, étancher
apagón       = coupure, panne de courant
aparato      = appareil, machine
               dispositif, agrès
apartar      = écarter, séparer
               mettre de côté
apartarse    = se pousser, s'éloigner de
               s'écarter de
apenàs       = peine (à), tout juste
               dès que
apestoso,a   = puant
apetecible   = appétissant, tentant
aplastar     = écraser
aplazar      = reporter, ajourner
aplomo       = aplomb, assurance
               confiance
apoderar     = déléguer ses pouvoirs à
apoderarse   = s'emparer de
apodo        = surnom
apostador    = ?
apostar      = parier, poster
apostillar   = apostiller (mettre une apostille)
apremiar     = presser, bousculer
               contraindre, obliger
aprendiz     = apprenti, débutant
apretar      = serrer, appuyer sur
               presser, tasser, pincer
               redoubler
aprieto      = situation difficile
aprovechar   = récupérer, se servir de
apuntar      = noter, pointer, souffler
               évoquer, signaler
               souligner, poindre
apuntarse    = s'inscrire, être partant
apunte       = annotation, croquis
               esquisse, souffleur, mise
apurar       = finir, épuiser, inquiéter
               gêner
apuro        = gros ennui, manque d'argent
               gêne
aquejar      = affliger
aquello      = ce, cela, ça
araña        = araignée, lustre
arañar       = griffer, égratigner
               érafler, grapiller
arder        = brûler
argüir       = arguer, prouver, argumenter
arpía        = harpie
arrancar     = arracher, déraciner
               retirer, enlever, démarrer
               lancer, partir
arrasar      = dévaster, ravager
arrastrar    = remorquer, trainer
               entrainer, convaincre
arrebatar    = arracher, fasciner
arrebatarse  = s'emporter
arredrar     = séparer
arredrarse   = s'avouer vaincu, se rendre
               reculer
arreglar     = arranger, régler, préparer
               pomponner
arremangar   = retrousser, relever
arrojado,a   = courrageux, intrépide
arrojar      = jeter, cracher, dégager
               chasser, rendre (vomir)
arroyo       = ruisseau, caniveau
arroz        = riz
arruga       = pli, ride
arrugar      = froisser, chiffonner, rider
               froncer
artesano     = artisan
artesiano    = ?
asaltar      = attaquer, assaillir, venir
               prendre d'assaut
ascenso      = avancement, promotion
               ascension
asco         = dégoùt
asediar      = assiéger, harceler
asegurar     = assujettir, resserrer
               assurer
asemejar     = faire ressembler à
               se ressembler
asentir      = admettre, acquiescer
asesino      = assassin
aseveración  = affirmation, assertion
así          = ainsi
asimismo     = aussi, de même
               de la même manière
               également
asolador     = dévastateur, destructeur
asolar       = dévaster, ravager
asomar       = apparaitre, sortir
               dépasser, passer
asomarse     = se pencher à
asombrar     = stupéfier, étonner
asombro      = stupéfaction, étonnement
asombroso    = stupéfiant, ahurissant
aspa         = aile (de moulin), pale
aspar        = dévider, mortifier
               tourmenter
aspereza     = rugosité, aspérité, âpreté
               rudesse
asquear      = dégoùter
asta         = haste, lance, pique
astuto,a     = astucieux, rusé
asunto       = sujet, affaire, liaison
asustar      = effrayer, faire peur à
atacar       = attaguer
               être surpris(e) par
               critiquer, s'en prendre à
               combattre
atajar       = couper court à, enrayer
               maitriser, couper
               prendre un raccourci
atajo        = raccourci, bande, ramassis
atalaya      = tour de guet
atar         = attacher
atenazar     = empoigner, tenailler
ateneo       = cercle (association)
atenter      = attenter
aterrar      = renverser, jeter à terre
               atterrer, effrayer
               terrifier
atiborrar    = bourrer
atiborrarse  = s'empiffrer (de)
atisbar      = observer, distinguer
               entrevoir
atisbo       = soupçon, début, moindre
               lueur, filet de lumière
atónito,a    = sans voix, stupéfait
atormentar   = torturer
atragar      = ?
atrapar      = attraper, décrocher, rouler
atrás        = derrière, arrière (à l')
               arrière (en), tôt (plus)
               avant
atrasado     = retard (en), traîne (à la)
               arriéré, retardé
atreverse    = oser
atrevido     = effronté, intrépide, osé
atronar      = ?
atropellar   = renverser, piétiner
               marcher sur
atropellarse = bredouiller
atusar       = tondre, lisser
atusó        = atusar
atuzó        = atusó
augustino,a  = augustin(e)
aula         = salle de classe
               salle de cours
aun          = même, bien que
ausencia     = absence, carence, manque
avalar       = avaliser, donner son aval à
avanzadilla  = avant-garde
avecinarse   = approcher, être proche
aventón      = dar un aventón a = déposer quelqu'un
avergonzar/se = faire honte, avoir honte de
averiguar    = rechercher
               chercher à savoir
avinguda (Catalan ?) = avenue, allée
avisar       = prévenir, appeler
aviso        = avertissement, avis, appel
azafrán      = safran
azar         = hazard
azotar       = frapper, fouetter
               s'abattre sur
azotea       = terrasse, ciboulot
azulejo      = carreau de faïence

Á
álamo        = peuplier
álgido       = culminant, glacial
ánimo        = courage
               avec l'intention (con ... de)
ápice        = iota, sommet, extrémité
               haut, bout
áspero,a     = rugueux, raboteux, âpre
               acerbe, revêche

B
bache        = trou, nid de poule, ornière
baches       = moments difficiles
               les hauts et les bas
baile        = bal, fête, soirée dansante
bajar        = descendre, baisser
bala         = balle
balazo       = balle, coup de feu
baldío/a     = inculte, vain
baldosa      = carreau, dalle
baldosar     = carreler, daller
bandeja      = plateau
bandera      = drapeau, bannière
barbaridad   = atrocité, ineptie
barnizar     = vernir
barojiano,a  = relatif à Pío Baroja (romancier) ou son œuvre
barranco     = précipice, ravin
barrer       = balayer
               battre à plate couture
barriendo    = barrer
barriga      = ventre
barro        = boue, argile, acné
barruntar    = deviner, pressentir
               prévoir
bastar       = suffire
bata         = robe de chambre, blouse
batido       = battu
baúl         = malle, coffre
beato,a      = dévot, béat, bigot
               Bienheureux
bellaquería  = friponnerie, méfait
berro        = cresson
bestia       = brute, bête
bisoñé       = toupet
bizquear     = loucher, être épaté
blancuzco,a  = blanchâtre
blandir      = brandir
blúmer       = ?
bocado       = bouchée, bout, morceau
bocajarro,a  = brûle-pourpoint (à)
               bout portant (à)
bodega       = cave, bar à vin, soute
               cale, épicerie
               magasim (América)
boina        = béret
boligrafo    = stylo-bille
bolitas      = billes
bolsa        = sac, bourse, poche
               bouillotte
bolsillo     = poche
bonanza      = calme plat, prospérité
bordear      = border, longer, friser
               frôler
borla        = pompon, gland (insigne)
borrar       = effacer, gommer, rayer
borroso,a    = flou, effacé (à moitié)
bostezar     = bailler
bostezo      = bâillement
botar        = lancer (bateau), virer
               jeter, sauter, rebondir
bote         = canot
braga        = culotte
bravucón(a)  = bravache, fanfaron
breñal       = ?
breve        = bref
brincar      = sauter
brinqué      = brincar
broma        = plaisanterie
bronca       = bagarre, huées
bronco/a     = grossier, rauque, rustre
brotar       = pousser, jaillir, naitre
               sortir
brote        = pousse, bourgeon
               médecine : accès, foyer
               éruption
brumoso,a    = brumeux
buhonero,a   = camelot, marchand ambulant
               colporteur
buitre       = vautour (~requin)
bullicio     = brouhaha, agitation
               animation
bulto        = bosse, masse, silhouette
               paquet
buñuelo      = beignet
               horreur (figuratif)
burlar       = semer, esquiver, tromper
               se moquer
burlón       = blagueur, plaisantin
               moqueur, railleur, taquin
burro/a      = âne, ânesse, bête
butaca       = fauteuil, place
butacón      = grand fauteuil
butifarra    = boudin catalan
               saucisse catalane (Languedoc : boutifarre)
               bas trop larges, foire
               fête
buzo         = plongeur, bleu de travail

C
cábala       = cabale, prédiction
               divination, hypothèse
               conjecture, supposition
caballeresco,a = chevaleresque
cabeceo      = hochement, cahots, tangage
cabecilla    = meneur, meneuse, leader
cabizbajo    = la tête basse
cabo         = cap, bout, cordage, caporal
               brigadier
cabrales     = fromage bleu des asturies
cabrón       = enfoiré, cocu, bouc
cacería      = partie de chasse
cachorro     = chiot, petit (de mammifère)
cadera       = hanche
cagar        = chier, foutre en l'air
               mettre les pieds dans le plat
cainita      = ?
caja         = boite, caisse, boitier
               coffre, cercueil
cajetilla    = boîte, paquet, dandy
cajon        = tiroir, caisse
calcetin     = chaussette, tirelire
calcular     = calculer, croire
caldo        = bouillon, consommé
               jus de cuisson, vin, bain
calentar     = chauffer, s'échauffer
               frapper
caleo        = ?
caleta       = ?
Caleta       = ville des Canaries
caliqueño    = cigare (marque)
caliza       = calcaire
callejero    = de la rue, ambulant
               répertoire des rues
calzada      = chaussée
calzar       = chausser
calzon       = slip
calzoncillos = slip
camarón      = crevette
campamental  = ?
campamento   = camping, campement, troupe
campanudo    = pompeux ?
cana         = cheveu blanc
cana al aire (echar una) = payer une partie de plaisir (se)
candelabro   = candélabre (chandelier
               réverbère)
candoroso    = candide
canje        = échange
canjear      = échanger
canoso/a     = grisonnant, e
cansancio    = fatique
cantimplora  = gourde
canturrear   = fredonner, chantonner
capilla      = chapelle
capitular    = capituler
capítulo     = chapitre
               llamar a capítulo = demander des comptes
capote       = capote, cape
capote a alguien (echarle un) = coup de main (donner un)
cara         = face
carajo       = bordel !
carajo (irse al carajo) = aller se faire voir
carajo (me importa un carajo) = rien  à foutre
carcelero,a  = maton, matonne
               gardien de prison, geôlier
               carcéral
carcomer     = ronger, consumer
carcomido/a  = vermoulu, rongé
carecer de   = manquer de
carecía      = ?
cariño       = affection, tendresse, soin
               chéri(e) !
carnada      = appât
carnet       = carte (identité, permis)
               agenda
carozo       = noyau
carpeta      = chemise
carrer       = ?
carrera      = course, parcours, études
               échelle, carrière
carro        = voiture, automobile
               charion, caddie
carrozón     = personne vieux-jeu dans ses gouts (habillement
               musique)
cartel       = affiche
               de cartel = de renom
cartera      = portefeuille
               porte-documents, serviette
               cartable
casaca       = casaque, queue-de-pie
casco        = casque
caserón      = bâtisse
casilla      = guichet, casier, case
               boite postale
caspa        = pellicules (cheveux)
castigar     = punir, endommager, frapper
               mortifier, malmener
               séduire, pénaliser
castigo      = punition, épreuve, pénalité
castitad     = chasteté
castrense    = militaire (adj.)
casual       = fortuit
casuarina    = [espèce d'arbre, arbuste] ?
cauce        = lit, canal, cours
cautivar     = capturer, captiver
cautiverio   = cautividad
cautividad   = captivité
cauto        = prudent
cavar        = creuser, bêcher, biner
cavilación   = réflexion, méditation
cayo         = ilôt bas et sablonneux
cazo         = casserole, louche, portion
               bol
cazuela      = ragout
cebolla      = oignon, filtre, crapaudine
ceder        = céder
cediese      = ceder (1era persona imperfecto subjuntivo)
cegar        = aveugler, boucher, murer
ceiba        = fromager
ceja         = sourcil, sillet
cejar        = renoncer
celda        = cellule
cenar        = diner
cenicero     = cendrier
cenicienta   = bonne à tout faire
               cendrillon, petit poucet
ceniciento,a = cendré, cuisant
ceniza       = cendre
ceñido,a     = ajusté, pédiculé, économe
ceñir        = mouler, ceinturer, entourer
               encadrer
cerca        = clôture, près, proche
cerciorar    = assurer
cerciorarse  = s'assurer
cerdo        = porc, cochon, salaud
               connard, enfoiré
cerebro      = cerveau, cervelle
               tête (figuratif)
cerilla      = allumette
cerradura    = serrure
certeza      = certitude
cervecero,a  = de la bière
               brasseur (euse)
cese         = arrêt, cessation, renvoi
               révocation
chaleco      = gilet
chapa        = plaque, capsule, badge
               jeton, serrure (américa)
chaparrón    = averse
chaqueta     = veste, cardigan
charco       = flaque d'eau
charla       = bavardage, causerie
               discours
charlar      = bavarder
chasquear    = faire claquer
               jouer un tour, tromper
               craquer
chatarra     = ferraille, camelote
chatura      = ?
checa        = comité de la police secrète
checo,a      = checoslovaco, a
checoslovaco = tchèque
cheque       = chèque
chicharo     = petit pois
chiquillo,a  = gamin, gosse, marmot
               bambin
chocho,a     = gâteux, gaga
choque       = collision, carambolage
               affrontement, bagarre
chorreo      = écoulement, ruissellement
               flot, perte
chorreón     = écoulement, filet, jet
               giclée, tache
chorro       = jet, filet, flot
chucho       = clébard, cabot, bâtard
               radin, rat
chupada      = goûter, coup de langue
               léchage, pipe, turlupe
               fumée, taffe
chupado,a    = épuisé, éreinté, claqué
               difficile, enlevé
               séquestré
chupar       = lécher, boire, picoler
               s'imbiber, absorber
chusco       = quignon (de pain)
chusco,a     = cocasse
ciego,a      = aveugle
cintura      = taille, ceinture
cita         = rendez-vous, citation
claro        = clair, vide, place libre
               clairière, éclaircie
clavado      = cloué, sonnant, planté
clavar       = planter, clouer, épingler
               fixer (yeux)
cloasma      = chloasma (maladie) ?
cobarde      = lâche
cobijo       = refuge, abri
cobrar       = encaisser, toucher
               être payé
cobre        = cuivre, sou
cobro        = encaissement
cochino,a    = cochon, sagouin, dégoutant
coger        = prendre
cogollo      = bourgeon, cœur, crème
coincidir    = coïncider, concorder
               être d'accord
cojear       = boiter, être bancal
               battre de l'aile, clocher
cojo,a       = boiteux, bancal
cojones      = couilles
cola         = queue, traîne, colle
colación     = collation
colada       = lessive
colado/a     = filtré
               en pincer pour (estar colado por alguien)
colar        = filtrer, passer
               écouler (fausse monnaie)
               faire croire à, glisser
               introduire, prendre
colcha       = couvre-lit
colega       = collègue, confrère
coletazo     = coup de queue
colilla      = mégot
colmo        = comble
colocar      = placer, mettre
columpiar    = balancer
columpio     = balançoire
comarca      = région
comensal     = convive
cometer      = commettre
comisura     = commissure
comodidad    = confort, commodité
compartir    = partager
complacer    = rendre heureux
               faire plaisir
componer     = composer, arranger, réparer
               décorer, parer
comprobación = vérification
comprobar    = vérifier
compuesta    = componer
compugido    = ?
compungido,a = contrit
compungir    = affliger
computar     = calculer, compter
comulgar     = communier, partager
concebir     = concevoir
concha       = coquille, carapace, écaille
               chatte (vulgaire)
concreto     = concret, précis, béton
conde        = comte
condesa      = comtesse
condesita    = ?
conejo       = lapin
confesarse   = avouer, se confesser
conformar    = conformer
confusionismo = confusion
conjeturar   = conjecturer
conjura      = conspiration, conjuration
conminar     = sommer, obliger, exhorter
               presser
conmovedor(a) = émouvant(e)
conmover     = émouvoir, ébranler
consabido    = classique, traditionnel
consagrar    = consacrer, sacrer
conseguir    = obtenir, atteindre
conserje     = concierge, gardien
conspicuo,a  = illustre, remarquable
consuelo     = consolation, réconfort
               soulagement
consuetudinario,a = consuétudinaire (en rapport avec le droit coutumier)
contender    = rivaliser, lutter
contener     = contenir, retenir
contienda    = contender, combat, conflit
contraseña   = mot de passe
contrastar   = contraster, trancher
               éprouver, résister à
conveniencia = convenance, bénéfice
               avantage
convivir     = cohabiter, coexister
               passer du temps avec
coño         = con
corbata      = cravate
corcho       = liège, bouchon
cordero      = agneau
correa       = courroie, bracelet, laisse
               anse, ceinture
corredor     = coureur, courtier, corridor
corregir     = corriger, déféquer
correoso/a   = caoutchouteux, mou, coriace
correr       = courir, couler, passer
               se propager, avoir cours
correria     = incursion, raid
               voyage rapide
corriente    = courant, ordinaire
corro        = cercle, ronde
               corbeille (bourse)
cortado,a    = gercé, tourné (lait)
               timide, coincé, haché
cortar       = couper
corte (la)   = cour (faire la cour à)
cortesano    = cour (de là), cour (à la)
cortesano,a  = courtisan, serviteur dévoué
               courtois
cortina      = rideau
corvina      = espèce de poisson ?
cosechar     = récolter, moissonner
               obtenir
coser        = coudre, agrafer
cosido       = couture
cosido,a     = cousu
costado      = flanc, côté
costar       = coûter, prendre (du temps)
costillar    = cage thoracique, flanc
               carré (de viande)
creer        = croire
cretona      = cretonne
creyera      = imperfecto subjuntivo creer
criado,a     = domestique, élevé, causer
               produire, grandir, devenir
criar        = nourrir, alimenter, élever
cristalera   = armoire à glace, verrière
               porte vitrée
cristalino   = cristallin
cuaderno     = cahier
cuajar       = cailler (lait), aboutir
               tenir
cuantioso    = nombreux
cuartear     = diviser, dépecer
               couper en quartier
cuartearse   = se lézarder, se fendre
               se crevasser
cuartel      = quartier général, caserne
               quartier
cubertería   = couverts, ménagère
cubículo     = chambre
cubilete     = gobelet
cucharada    = cuillérée
cuchipanda   = ripaille, bombance
cuello       = cou, col, goulet
cuentista    = conteur, menteur
cuento       = conte, histoire
cuerda       = corde, ressort (horloge)
cuerdo       = raisonnable, judicieux
               un sage
cuero        = cuir
cuesta       = côte
culata       = culasse, croupe
cumplir      = accomplir, exécuter, tenir
               respecter, avoir, purger
               faire, expirer
               faire son devoir
cuneta       = caniveau, fossé
cuña         = cale, coin
cuña (tener) = avoir du piston
cuñado,a     = beau-frère, belle-sœur
cuño         = poinçon
cuota        = cotisation, frais
               quote-part, audimat
curda        = cuite (familier)
curdo/a      = rond(e), soulard(e)
cursilería   = mauvais goût, manières
               snobisme, bibelot
curtido      = tannage
curtido,a    = tanné, expérimenté
               chevronné
custodia     = garde, ostensoir
cuyo/a       = dont le, la

D
dado         = donné
daiquirí     = ponche
dañar        = abimer, faire mal, blesser
               nuire à
daño         = dommage, dégat, mal
               blessure, plaie, douleur
               souffrance
dar          = donner
débil        = faible, affaibli
debilitar    = affaiblir
decimonónico = du 19ème siècle, dépassé
deducir      = déduire
deduje       = deducir
defección    = défection
dejar        = laisser, quitter
               abandonner
delatar      = dénoncer, trahir
delgado      = mince, maigre, fin
delibarodo,a = délibéré
demacrado    = émacié, décharné
demás        = autre, autres (les)
               reste (le)
               à part ça (por lo ..)
demás (por lo ..) = part (à ... ça)
demorar/se   = retarder, s'attarder
deparar      = présenter, causer, procurer
               offir
deportivo,a  = sportif, sport, fair-play
               de plaisance
depositar    = déposer
derramar     = répandre, renverser
derredor     = tour, contour
derribar     = démolir, abattre, renverser
derrota      = échec, défaite
               route (Nautique)
derrotar     = battre, vaincre, accabler
               dériver
derrotero    = chemin
derrumbar    = démolir, abattre
               s'effondrer
dervanecerse = s'évanouir
               perdre connaissance
               se dissiper, disparaitre
desafiar     = défier
desaforado,a = démesuré, épouvantable
               acharné
desaforar    = léser, destituer, exclure
desafortunado = malchanceux, malheureux
desahuciar   = condamner
desalentador = décourageant, démotivant
desalentar   = décourager, rebuter
desaliento   = découragement, abattement
desalmada    = sans-cœur
desaprensivo,a = sans-gène
desasosiego  = trouble
desastroso   = désastreux, nul
desatar      = détacher, déchainer, délier
desazón      = fadeur, peine, ennui
desbocar     = casser, briser
               se jeter dans
               se déverser dans
desbocarse   = s'emballer, prendre la main
               embarquer, flamber (prix
               cours)
desbordar    = sortir de, dépasser
               pousser à bout, déborder
desbrozar    = débroussailer, désherber
descanso     = repos, congé, vacances
               soulagement, entracte
               pause, palier
descarado    = effronté
descararse   = parler ou agir avec insolence ou effronterie
descargo     = déchargement, excuse
               décharge, reçu
descojonarse = se poiler, se marrer
               se foutre de qque chose
               qqu'un
descomunal   = énorme, immense, colossal
desconchado  = écaillure
desconchado,a = dêcrépi, écaillé
descontar    = déduire, rabattre
               escompter
descortés    = impoli
descreído,a  = incroyant, e
descuido     = négligence, inattention
desdén       = dédain, superbe
desdeñar     = dédaigner
desdichado   = malheureux, pauvre
               malchanceux, peureux
               trouillard
desempeñar   = remplir, exercer, jouer
               dégager
desenganchar = décrocher, dételer
desengañar   = informer correctement
               ouvrir les yeux, déchanter
               tomber de haut
               perdre ses illusions
desenlace    = dénouement
desesperanzador,a = désespérant
desfogar     = décharger
               donner libre cours à
               faiblir, se calmer
desgarrón    = déchirure
deshacer     = faire fondre, défaire
               abattre, briser, fermer
               liquider
desharrapado = en haillons, déguenillé
               va-nu-pieds
deshecho     = déchet, détruit, en miettes
               défait
desidia      = laisser-aller
designio     = dessein, volonté, plan
               projet
deslealtad   = déloyauté
desleír      = délayer
deslizamiento = patinage, glissement
deslizar     = glisser, faire glisser
               insinuer
deslizarse   = se faufiler, s'introduire
               se déplacer
deslumbrante = éblouissant
desmán       = excès, abus, agissements
desmemoriado = qui a mauvaise mémoire
desmemoriarse = perdre la mémoire, oublier
               ne pas se rappeler
desmoronar   = abattre, faire ébouler
               décourager
desmoronarse = s'écrouler, s'effondrer
               se décourager
desolador    = désolant, navrant
               attristant
desollar     = écorcher, ruiner
desorbitadamente = ?
desorbitar   = grossir
               sortir de son orbite
               s'envoler
despachar    = vendre, servir, congédier
               traiter, régler, expédier
               avoir un entretien
despacho     = bureau, vente, guichet
               dépêche, mandat, envoi
despacio     = lentement, doucement
despacioso   = despacio ?
despampanante = canon, épatant
despavorido,a = épouvanté
despechar    = énerver, insulter, sevrer
despecho     = dépit
despedida    = adieux, renvoi, congé
               licenciement
despedir     = faire ses adieux, jeter
               renvoyer
despejar     = dégager, débarasser
               clarifier, éclaircir
               dissiper
despejarse   = se dégager
               se changer les idées
despellejar  = dépouiller, écorcher
               dépecer, peler, éplucher
               dire du mal (de qqn)
desperdigado = dispersé, éparpillé
desperdigar  = éparpiller
desperezarse = s'étirer
despertar    = réveiller, éveiller
               provoquer
despertar (un) = réveil
despiadado   = impitoyable
desplante    = insolence
desplomarse  = s'effondrer
desplome     = écroulement, saillie
despojar     = dépouiller
despojarse   = se priver de
               se dépouiller de
despreciable = ?
despreciar   = mépriser, rejeter
desprender   = détacher, décoller, dégager
               diffuser
desquiciado  = fou, taré, cinglé
desquiciar   = rendre fou
               faire sortir de ses gonds
destacar     = souligner, détacher
               ressortir, se distinguer
destartalado,a = démantibulé, délabré
               déglingué
destello     = éclat, scintillement, lueur
destreza     = habileté, adresse
destripar    = étriper, désosser
destrozar    = abimer, détériorer
               détruire
desvaído     = pâle, passé, vague, flou
desvalimiento = abandon, délaissement
desvanecer   = effacer, éteindre, dissiper
               faire disparaitre
               mettre fin, couper court
desvelar     = empêcher de dormir
               dévoiler, se coucher tard
desvelo      = insomnie, effort
desvencijado = délabré
desventrada  = ?
desventurado,a = malchanceux, malheureux
               infortuné, sans esprit
               avare
detallismo   = méticulosité
               commerce au détail
detenerse    = s'arrêter
devolver     = rendre, rembourser
               renvoyer, remettre
di           = dar, decir
diáfano      = diaphane, translucide
               clair, limpide
diario       = quotidien, journalier
               journal
difuminado   = estompé
difundir     = diffuser, répandre
dilatado,a   = dilaté, vaste
dilatar      = dilater, faire durer
               prolonger
dintel       = linteau, limite, seuil
dirimir      = résoudre, trancher, annuler
discrepencia = divergence, désaccord
discurrir    = passer, s'écouler
               se dérouler, réfléchir
               concevoir, inventer
diseñar      = dessinner, concevoir
diseño       = dessin, conception
disfrace     = ?
disfrazar    = déguiser
disfrutar    = jouir, profiter, s'amuser
disparo      = coup de feu, tir
displicencia = indifférence, froideur
               découragement, nonchalance
displicente  = déplaisant, désagréable
               acrimonieux, acerbe, aigre
               nonchalant
disquisición = exposé
disyuntiva   = dilemme
ditirambo    = dithyrambe (cantique
               louange, panégyrique)
divisar      = apercevoir, dicerner
               entrevoir
dolencia     = douleur
dramatismo   = intensité dramatique
dudar        = douter, hésiter
dudoso       = improbable, hésitant
               douteux
dueño        = propriétaire
dulzona      = ?
dulzor       = ?

E
echar        = lancer, jeter, mettre
               faire
echarse a perder = s'abimer, tourner mal
efímero,a    = éphémère
egipcio      = égyptien
eludir       = éviter, esquiver, ignorer
embalsamador = embaumeur
embargar     = saisir, paralyser
embarrado    = plein de boue, crotté
emboscado,a  = embusqué
emboscar     = embusquer
embotar      = émousser, abrutir
embriaguez   = ivresse
embuste      = mensonge
empapar      = tremper, éponger, boire
               absorber
empecinado   = fabricant ou vendeur de poix
empecinado,a = têtu, obstiné
empecinarse  = se buter
empeñado     = gagé
empeñar      = mettre en gage, donner
               engager, s'endetter
empeño       = mise en gage, acharnement
empinado     = raide, escarpé, abrupt
               sur la pointe des pieds
               envolé
empotrado    = encastré
empresario,a = entrepreneur, patron
empujar      = pousser
empuje       = poussée, verve, vivacité
               allant, entrain
empuñar      = empoigner, braquer
enardecer    = enflammer, motiver
encabezar    = être en tête de
               mettre l'entête à
encabronarse = se mettre en colére
               se foutre en rogne
encajar      = emboîter, faire entrer
               ajuster, remettre, essuyer
               encaisser
encaje       = dentelle
encallar     = échouer
encallarse   = rester lettre morte
encallecer   = devenir calleux, durcir
               endurcir
encaramar    = jucher
encargar     = charger (quelqu'un de quelque chose)
               commander
encarnizado,a = archarné
encarnizar   = acharner, rendre cruel
encasquetar  = asséner
               enfoncer sur la tête
encauzar     = canaliser, mener, orienter
encender     = allumer, enflammer
               provoquer
encerrar     = enfermer
encharcar    = détremper
encía        = gencive
encierro     = réclusion, mise au toril
encima       = dessus, en plus
encina       = chêne vert
encoger      = faire rétrécir, contracter
               rétrécir
encogimiento = rétrécissement, timidité
encono       = animosité
encrucijada  = croisement, carrefour
encuadernador,a = relieur(se)
encuadernar  = relier
encuerar     = ?
enero        = janvier
enfáticamente = ?
enfático     = emphatique, solennel
               grandiloquent
enfermar     = contaminer, rendre malade
enfermizo,a  = maladif, insalubre, malsain
enfisema     = emphysème (médecine : gonflement cellulaire ou pulmonaire)
enflaquecer  = maigrir, amaigrir
               faire maigrir
enfocar      = faire la mise au point de
               braquer, diriger
               aborder (figuratif)
enfrascado   = absorbé
enfrentar    = affronter, opposer
               mettre face à face
enfundar     = rengainer
enfurecer    = rendre furieux
engalanar    = parer, pomponner, décorer
               se faire beau
engañar      = tromper
engaño       = tromperie, mystification
engañoso,a   = trompeur
engavetado   = ?
engreído,a   = suffisant
engrosar     = augmenter, faire grossir
               épaissir, grossir
engullir     = engloutir
enmarañado   = emmêlé, en bataille, confus
               embrouillé
enmarañar    = emmêler, enchevêtrer
enredadera   = grimpant, liseron
enredar      = emmêler, embrouiller
               trafiquer, intriguer
               faire des bêtises
ensañar      = rendre furieux
ensayo       = répétition, test, essai
enseres      = affaires, effets personnels
               matériel
ensortijado  = bouclé
entablar     = commencer, engager, entamer
               amorcer, nouer
entelar      = entoiler ?
enterado     = averti, expert
entibiar     = faire tiédir, attiédir
               freiner, modérer, affaiblir
entierro     = enterrement
entonces     = alors
entradilla   = titres
entrañable   = cher, profond
               attendrissant
               entrañablemente
entregar     = remettre, livrer, se rendre
entresijos   = dessous (les)
entretela    = triplure, bougran
               entretaille
entreverado  = entremêlé
envenenar    = empoisonner, envenimer
envolver     = envelopper, enrouler
               enjôler
enzarzar     = envenimer
enzarzarse   = s'emmêler dans des ronces
               se disputer
equivocar    = confondre
erguir       = dresser, redresser, lever
erizamiento  = hérissement
erizao       = ?
erizar       = hérisser
escabroso    = inégal, scabreux, délicat
escalinata   = perron
escama       = écaille, paillette
               squame (peau)
escampar     = cesser de pleuvoir
escaparate   = vitrine
escaramuza   = escarmouche
escaso       = maigre, faible, rare
escatimar    = lésiner sur, réduire
               diminuer, épargner, ménager
escena       = scène
escenografia = scénographie
escoger      = choisir
escoltar     = escorter
esconder     = cacher
escondite    = cachette, cache
               cache-cache
escondrijo   = repaire, cachette
               coin caché
escopeta     = fusil (de chasse)
escozor      = brûlure, piqure
escriba (un) = scribe
escribir     = écrir
escritorio   = bureau, secrétaire (meuble)
escroto      = scrotum
escrúpulo    = scrupule, dégoût
               méticulosité, scrupulums
escrutinio   = dépouillement du scrutin
               examen
escuálido,a  = décharné, émacié, maigre
escudo       = bouclier, blason, armes
               écu
escuetamente = ?
escueto      = simple, modeste, dépouillé
               petit, succint, mini
escupir      = cracher
escupitajo   = crachat
ese,a        = ce, cette, ce ...-là, ces
               ces ...-là
esencia      = essence, parfum, essentiel
esforzar     = forcer, faire des efforts
esfumar      = estomper
esfumarse    = s'envoler, s'évaporer
               disparaitre, se volatiliser
esmero       = soin, application
espalda      = dos
espantar     = faire fuir, épouvanter
espanto      = frayeur, effroi, fantôme
               horreur
espantosa    = épouvantable, horrible
               terrible
espejuelo    = gypse, lamelle de talc
               miroir aux alouettes
               reflet
espejuelos   = lunettes
               verres de lunettes
espesar      = épaissir
espesisimo   = ?
espeso       = épais
espesura     = fourré, épaisseur, densité
espetar      = embrocher, traverser
               percer, sortir, débiter
espigado,a   = monté en graine, élancé
espigar      = glaner, faire un tenon
               butiner, épier
espin        = spin
espirar      = expirer, exhaler
espolear     = éperonner
espolón      = ergot, môle, jetée
               éperon (d'un bateau)
espolonazo   = ?
espuela      = éperon, aiguillon
espuma       = mousse, écume
esquela      = faire-part
esquella     = ?
esquema      = schéma
esquerra     = ?
esquina      = coin
esquinado,a  = en coin, acariâtre
esquinar     = former un coin
               placer en coin, indisposer
esquisito    = exquis
establo      = étable
estallar     = éclater, exploser
estallido    = explosion, détonation
estampa      = estampe, image
               allure (aspect)
estampida    = débandade
estampido    = détonation, déflagration
               explosion
estancia     = séjour, pièce, ranch, ferme
estanque     = étang
estanquillo  = ?
estante      = bibliothèque, rayon
               étagère, étai
estanteria   = rayonnage, étagères
estaquilla   = chevillette
estirar      = étirer, tendre, faire durer
estocada     = estocade, botte (escrime)
estorbar     = gêner
estrafalario = saugrenu (péjoratif)
               bizarre
estragar     = corrompre, ravager, gâter
               pervertir
estrago      = ravage, dégât
estratega    = stratège
estrechar    = serrer
estrellar    = fracasser, briser
estremecimiento = frémissement
estría       = vergeture
estropear    = abîmer, faire échouer
estrujar     = essorer, serrer, enlacer
               froisser, dépouiller
               saigner
estrujarse   = se creuser la tête
estuche      = étui, coffret, trousse
estupendo,a  = excellent, épatant
etílico      = ethylique
               en état d'ivresse
eufemístico,a = euphémique
expediente   = dossier, enquête
explanada    = esplanade
               terrain découvert
exquisitez   = ?
exquisito    = exquis, raffiné
extemporáneo,a = hors saison, hors sujet
               déplacé
extenso,a    = étendu, long, en détail
extraño,a    = étrange, étranger, étonnant
extraviar    = perdre
extremeño,a  = d'Estrémadure

É
ése,a        = celui-là, celle-là, lui
               elle
éxito        = succès, bestseller, tube
               réussite

F
fabe         = haricot
fachada      = façade
falso,a      = faux
faltar       = manquer, rester (quedar)
fama         = célébrité, réputation
fango        = boue
fantasmón,ona = crâneur, euse
farol        = réverbère, fanal, feu
               bluff
farsante     = comédien
               imposteur (simulateur)
faz          = face
fe           = foi, confiance, certificat
fechar       = dater
feo          = laid, sale, affront
ferrobus     = autorail, micheline
ferrocarril  = chemin de fer
fiel         = fidèle
figura       = figure, silhouette
fijar        = fixer
fijarse      = faire attention
fijo,a       = fixe, fidèle, sans faute
fila         = file, rang
finca        = propriété, immeuble
fingir       = feindre, faire semblant
fláccido,a   = flasque
flácido,a    = flasque
flaco        = maigre, mon coco
               ma cocotte
flamente     = ?
flaquear     = flageoler, faiblir
flatulencia  = flatulence
flatulento   = flatulent
flechazo     = coup ou blessure de flèche
               coup de foudre
flema        = lymphe, flegme
flojo,a      = lâche, léger, faible
               médiocre
flotar       = flotter
flote        = flottage, flot (à)
fluir        = couler
fogón        = fourneau, chaudière
foguear      = nettoyer (une arme)
               habituer au feu, cautériser
follaje      = feuillage
fonda        = auberge
fondear      = mouiller
fondo        = fond, a fondo = à fond
forcejear    = se débattre, se démener
forjador     = forgeron, forgeur
forjar       = forger
fornido,a    = robuste
fortaleza    = forteresse, vigueur, force
               résistance
fosa         = fosse
fosforero,a  = relatif aux allumettes
               allumettier
foso         = fosse, fossé, tranchée
               dessous
fracasar     = échouer
fracaso      = échec
fragor       = fracas, grondement
fraile       = frère, moine
               blennie fluviatile
franquear    = dégager, franchir
               affranchir
frasca       = ?
frasco       = flacon
fregadero    = évier
frenar       = freiner, réfréner
frente       = front, devant, de face
               nez à nez
fresno       = frêne
frigio,a     = phrygien
frondosisimo = muy frondoso
frondoso,a   = touffu, luxuriant
fruición     = plaisir, délectation
fugaz        = fugace, étoile filante
fundamento   = fondations, fondement
               raison
furibondes   = ?
furibundo,a  = furibond, furieux
               enthousiaste, fervent

G
gabán        = pardessus
gafa         = pied-de-biche, gaffe
               lunettes
galardón     = prix (récompense)
galeón       = galion
gallardón    = galardón ?
gallego,a    = galicien
gallo        = coq, chef, couac, limande
gana         = envie
ganancias    = profits, bénéfices
ganas        = envie, appétit
gancho       = crochet, rabatteur, compère
               portemanteau
garabatear   = gribouiller
garganta     = gorge
garito       = tripot, boui-boui
garlopa      = varlope (grand rabot)
garra        = griffe
garrafa      = carafe
garrapatear  = griffonner, gribouiller
gaseoso,a    = gazeux
gastado,a    = usé
gastar       = dépenser, user, consommer
gaveta       = tiroir
gavetero     = ?
gazmoño      = prude
gazmoño (familier) = bégueule, sainte nitouche
gemir        = gemir
gestión      = démarche, gestion
gilipollez   = connerie
gime         = gemir (3° pers. sing. ind. y 2° pers. sing. imper.)
ginebra      = gin
Ginebra      = Genève
glorieta     = rond-point, tonnelle
golpe        = coup, accrochage
golpear      = frapper
golpista     = de coup d'état, putschiste
gordezuelo   = ?
gordo        = gros lot
gordo,a      = gros, grosse, mon coco
               ma cocotte
               faire une scène (armar la ..)
gordo,a [adj] = gros, gras
               important (de poids)
gorra        = casquette
gorro        = bonnet
gotoso,a     = goutteux
gozar        = se réjouir
grabado      = gravure
grabadora    = magnétophone
grabar       = graver, enregistrer
gracia       = grâce, drôlerie, gout
               talent
granero      = grenier
graznido     = croassement, cri d'orfraie
gremio       = corporation, camp
griterio     = cris
grueso       = épaisseur, le gros de
grueso,a     = gros, épais
gruñir       = grogner, gronder
               ronchonner, grincer
guagua (América) = bus, bébé
guantazo     = baffe
guaperia     = bravade
guarecer     = abriter
guirigay     = charabia, brouhaha
guisa        = manière, façon
guisar       = cuisiner, cuire, préparer
gula         = gloutonnerie
guyabo,a     = beau gosse, belle fille
               goyavier, goyave

H
habilidoso,a = habile, habilidosamente
halagador    = flatteur
halagar      = flatter
halago       = compliment, éloge
               flatterie
hallar       = trouver
hallazgo     = trouvaille, découverte
hambre       = faim
harapiento   = en haillons
hartar       = gaver, fatiguer
hartazgo     = indigestion
hebilla      = boucle (ceinture)
hechizar     = ensorceler, jeter un sort
               envoûter
hechizo      = sort, sortilège
               ensorcellement, envoûtement
               charme
hechizo,a    = fait maison, fait main
heder        = empester
hedor        = puanteur
helado       = glace
helado,a     = gelé, glacé, de glace
hemeroteca   = bibliothèques de périodiques
heredar      = hériter
herido       = blessé
hermandad    = fraternité, confrérie
               jumelage
hermeroteca  = ?
hervir       = faire bouillir, bouillir
               bouillonner, grouiller
hierro       = fer, lame
hígado       = foie
               tener higado = avoir du cran
hilera       = rangée
hilo         = fil, filet, lin
hiperbólico,a = hyperbolique
hocico       = museau, groin, gueule
hoguera      = bûcher, feu de joie
hoja         = feuille, lame, battant
hojear       = jeter un coup d'œil à
               feuilleter
hombría      = virilité
hombro       = épaule
honda        = fronde
hondo,a      = profond(e)
               au plus profond de
hondonada    = dépression (du terrain)
honrado,a    = honnête
hormigón     = béton
horrendo,a   = horrible, atroce
hortaliza    = légume
hostigar     = gêner, déranger, harceler
               écœurer
hoya         = trou, cratère, vallée
               cuvette, fosse, tombe
hoyo         = trou, tombe
hueco        = creux, place
huerfano     = orphelin
hueso        = os, noyau, peau de vache
               bête noire
               sinécure (América)
hule         = toile cirée
humeante     = fumant
hundir       = enfoncer, plonger, couler
               planter (ongle, griffe)
               abattre (personne)
huraño,a     = farouche
hurgar       = fouiller

I
ideario      = idéologie, doctrine, idéal
               idéaux
idóneo,a     = idéal, indiqué, bon
ilegible     = illisible
impar        = impair, sans paire
impartir     = donner, répartir
               dispenser (un cours)
impetu       = fougue, force, élan
               impétuosité, énergie
               magnitude d'un vecteur
impoluto,a   = immaculé, irréprochable
impostar     = projeter
               émettre un son (musique)
imprescindible = indispensable
inabarcable  = trop vaste
inagotable   = inépuisable
inalcanzable = inaccessible
inaplazable  = qui ne peut pas être reporté -> aplazar
inatrapable  = ? atrapar
inaugurar    = inaugurer
incipiente   = naissant
incomodidad  = ne pas être confortable
               pratique
inconfundible = caractéristique
incorporar   = incorporer, ajouter
               asseoir, redresser
increpar     = blâmer, injurier
indagación   = investigation
indagador    = investigateur
inducir      = inciter, induire
               conduire à, mener à
indujeron    = inducir
indumentaría = costume, vestimentaire
ingente      = énorme
ingresar     = déposer, mettre, verser
               faire entrer, être admis
               rentrer
inocuo       = inoffensif, fade
inquina      = aversion, rancœur
insidioso,a  = insidieux
insinuar     = insinuer, faire des avances
               draguer
insulso,a    = fade, insipide
intellectualidad = intellectualité
               intellectuels
intemperie   = dehors, belle étoile (à la)
               intempérie
intentona    = tentative téméraire
intricado    = ?
intrincado   = compliqué, complexe
intuir       = avoir l'intuition de
               pressentir
invernizo    = hivernal
inverosímil  = invraisemblable
irrechazable = rechazar ?
irredimible  = irrachetable

Í
ínfulas      = prétention, vanité

J
jabón        = savon
jadeante     = haletant, hors d'haleine
jadear       = haleter
jalar        = tirer, haler, attirer
               bouffer
jamabar      = ?
jarama       = ?
jaramago     = sisymbre (Bot.)
jarana       = java, grabuge, émeute
               guitare
jaspeado     = jaspé
jerarca      = hiérarque, dignitaire
               dirigeant
jerarquía    = hiérarchie
jerga        = jargon, argot, paillasse
               grosse toile
jipi         = hippie ?
jirón        = lambeau, bordure
joder        = baiser, faire chier
               emmerder, niquer
joder !      = merde !, putain !
jodido (vulgar) = mal foutu, emmerdé, foutu
jofaina      = bassine
jornada      = journée, étape
joseantonianos = ?
jubilado     = retraité
jubilar      = mettre à la retraite
jubilo       = joie
judía        = haricot
judío,a      = juif(ive)
juerga       = noce, foire, bombe
               bringuek
jugar        = jouer
jugo (de)    = jus, suc, jugué --> jugar
juguetear    = jouer
juicio       = jugement
juiciosamente = con juicio
juntura      = jointure, joint
               articulation

L
labrar       = cultiver, labourer
               travailler
lacerante    = aigu, blessant, déchirant
ladera       = flanc, versant
ladero,a     = latéral
ladrar       = aboyer, brailler
ladrido      = aboiement, braillement
laguna       = lagune, lacune
lamentar/se  = regretter, déplorer
               se lamenter
lamer        = lécher
lamía        = lamer ?
lámpara      = lampe, tache (figuré)
lánguido     = languide (langoureux
               languissant), fragile
lapiz        = crayon
laquear      = laquer
lasca        = éclat de pierre
lástima      = pitié, peine, dommage
lastimoso,a  = qui fait de la peine
               navrant, pitoyable
               déplorable
lastrar      = lester
lastre       = pierre de mauvaise qualité
               lest, handicap, obstacle
               fardeau, gêne
lata         = boite (de conserve)
               casse-pieds
latir        = battre
latoso       = barbant, raseur
lauro        = gloire, triomphe
lazo         = nœud
lealtad      = loyauté
lecho        = lit, fond (lac, canal)
               couche
lechuza      = chouette
lejanía      = éloignement
lengua       = langue
               ir de lengua = ne pas tenir sa langue
letal        = mortel
letra        = lettre, écriture, traite
               paroles
leve         = léger, bénin, petit
levedad      = légèreté, bénignité
               petitesse
libra        = balance
librar       = livrer, faire, émettre
               délivrer
librarse     = s'échapper
               se débarrasser de
librero      = libraire, bibliothèque
               du livre
libreta      = carnet, livre de comptes
licuar       = liquéfier
liderato     = liderazgo
liderazgo    = première place, leadership
lidia        = combat
lidiar       = lutter, combattre
lima         = lime, limettier
limar        = limer, polir
limosna      = aumône, charité
limpiamente  = adroitement, proprement
lindar       = être contigu
               être en contact, toucher
               flirter, en contact
               être bordé
linde        = limite, frontière
lindero      = limite
lindero,a    = contigu
lindo,a      = joli
linterna     = lampe de poche
lista        = liste, bande, latte, rayure
listo,a      = malin, dégourdi, prêt
llama        = flamme, lama
llamar       = appeler, nommer
               donner un nom, sonner
               toquer, attirer, dire
llamarada    = flambée, rougeur
llameante    = flambant ?
llamear      = flamber
llanura      = plaine
llenar       = remplir, combler
llevar       = porter, transporter
llover       = pleuvoir
locuacidad   = loquacité
locura       = folie
lograr       = réussir, parvenir
loma         = colline
lomo         = dos, échine
losa         = dalle, pierre, plaque
               vaisselle
losar        = daller, carreler
lote         = lot, part
loza         = faïence, vaisselle
luciar       = briller
luego de     = après
lujo         = luxe

M
macarela     = ?
macizar      = rendre massif
               boiser en plein
macizo       = massif
macizo,a     = massif, baraqué
maderamen    = boisage
madriguera   = tanière, terrier
madrina      = marraine, témoin (mariage)
madurar      = mûrir
maestrazgo   = dignité
               titre de grand maître (militar)
mago,a       = magicien, enchanteur
malagradecido = agradecido
malanga      = ?
maldecir     = maudire, pester, injurier
               traiter de tous les noms
               jurer, maldijo --> maldecir
malecón      = jetée
maleza       = mauvaises herbes
               broussaille
malignidad   = malignité
malogrado    = décédé, défunt
malvado,a    = méchant
mamey        = ?
mampostería  = maçonnerie
mancha       = tache, la Manche
manchar      = tacher, se salir
mandar       = ordonner, envoyer
               commander
manejar      = manier, mener, gérer
               conduire
manga        = manche, tuyau, chausse
               perche
mango        = manche (anse, poignée)
               manguier, mangue
manicomio    = asile (d'aliénés)
manifiesto,a = manifeste
maniobra     = manœuvre
manotazo     = claque
manta        = couverture, toile de coton
               calicot, cossard, flemmard
               fainéant, paresseux
               raie manta
mantel       = nappe
maricón      = pédé
marimacho    = virago (femme d'allure masculine
               autoritaire et criarde)
mármol       = marbre
marrasquino  = marasquin (liqueur)
masa         = masse, totalité, total
               pâte
masía        = ferme (en catalogne)
mata         = buisson, touffe
matanza      = tuerie, massacre, abattage
               porc de boucherie
mataperros   = ?
matorral     = fourré
mayimbes     = ?
meapila      = ?
mear         = pisser
médano       = dune, banc de sable
mediado, mediados (a) = moitié (à), mi
               moitié (à la), mi (à la)
mediante     = grâce à, moyennant
               moyen (au .. de)
               aide (à l'... de), par
mediar       = intercéder, intervenir
medida       = mesure, dimension, part
mejilla      = joue
melánico     = ?
melcocha     = ?
menesteroso,a = nécessiteux (-euse), pauvre
menestoroso  = ?
mente        = esprit, intention
mentira      = mensonge
mentiroso,a  = menteur, euse
menudear     = répéter, abonder
menudo (a menudo) = souvent
menudo,a     = menu, petit
merecer      = mériter
mermelada    = confitûre
mero         = mérou
mero,a       = seul
merodear     = rôder
miedo        = peur
miga         = mie, miettes, substance
               moelle
migaja       = quignon de pain, miette
migar        = couper le pain en petit morceaux
migas        = ragoût de pain frit avec des lardon
milagro      = miracle
militar      = servir, militer, militaire
militarote   = ?
milla (la)   = mille marin
mingitorio   = urinoir
minifalda    = minijupe
mirilla      = judas (de porte)
misa         = messe
mitin        = meeting
mito         = mythe, personnage, figure
mochila      = sac à dos
mochilla     = mochila ?
mocho        = balai-serpillière
mocho,a      = émoussé, étêté, écorné
moco         = morve
modorra      = sommeil profond
               engourdissement
               assoupissement
mojar        = mouiller, tremper
moler        = moudre, épuiser, éreinter
               faire chier, emmerder
               fatiguer
molestar     = gêner, déranger, faire mal
molesto,a    = gênant, faché
molicie      = ?
molido       = moulu, épuisé, éreinté
               harassé, flapi
               roué de coups
momia        = momie
monago       = enfant de chœur
monaguillo   = enfant de chœur
montón       = tas
moro,a       = arabe, musulman, musulmane
               Maure, noir, jaloux
               possessif
mosén        = mestre
               meistre (commandant d'un régiment sous l'ancien régime)
mossèn       = mot catalan : prêtre ?
mostrador    = comptoir
motear       = tacheter, moucheter
mudar        = changer, muer
mudo,a       = muet
mueca        = grimace
muelle       = quai
mullida      = mullir
mullir       = assouplir
multitudinario = massif
muñeca       = poignet, poupée, piston
musitar      = marmotter
mutuamente   = ?

N
nailon       = nylon
naipe        = carte (à jouer)
nalga        = fesse
nato,a       = né, de plein droit
nave         = navire, vaisseau, hangar
               nef
necio,a      = idiot, sot
negar        = nier, refuser
nerviosismo  = nervosité
nexo         = lien, rapport, liaison
ni siquiera  = même pas
nidal        = nichoir, pondoir
               nichet (œuf en plâtre ou marbre)
nitido       = clair, net
nombramiento = nomination
nombre       = nom, prénom, renom
noquear      = mettre ko
noticiario   = actualités, informations
novato       = débutant
novelesco,a  = romanesque
nube         = nuage, nuée
               taie (dans l'œil)

O
obligar/se   = obliger, engager à (s')
obrar        = faire, bâtir, construire
               agir, trouver (se), être
obsequiar    = faire cadeau, offrir
obsequio     = cadeau
ocio         = temps libre, loisir
               divertissement
ocioso,a     = oisif, oiseux
odiar        = haïr, détester
odio         = haine
ombligo      = nombrir
ominoso      = horrible, répugnant
               abominable, malheureux
onda         = onde, ondulation
ordenar      = ordonner, ranger, classer
orilla       = bord, lisière, trottoir
orillar      = atteindre le bord, border
               arranger
orina        = urine
oriundo      = originaire, venir de
               sportif étranger dont le père ou la mère ne le sont pas
orsianos     = ?, orteguiano
oscuro,a     = obscur, foncé, sombre
ostentar     = détenir, occuper, étaler
               afficher, montrer
otoñal       = automnal, âgé, âge mûr (d')
               automne de la vie (à l')
otorgar      = octroyer, attribuer
               conférer

Ó
óleo         = huile
óxido        = rouille, oxyde

P
padecer      = souffrir de, supporter
paja         = paille, foin, osier
paja (vulg.) = branlette
pajar        = grenier à paille
pal          = ?
pala         = pelle, raquette, batte
paladar      = palais
palurdo      = lourdeau, grossier, balourd
pamema       = histoire, minauderies
               feinte
panadería    = boulangerie
panadero,a   = boulanger(ère)
panameño,a   = panaméen(-ne)
pandilla     = bande (d'amis)
panetela     = ?
pantalla     = écran, abat-jour, paravent
pantano      = marais, retenue d'eau
pantorrilla  = mollet
pañado       = poignée, quelques
pañete       = petit drap
               toile de mauvaise qualité
               linge
paño         = tissu, torchon, serviette
pañuelo      = mouchoir, foulard
papel        = papier, rôle
papeleta     = billet, affaire difficile
               bulletin de notes
par          = paire
paradero     = endroit, oú qqn se trouve
               habitte, fin, terme, arrêt
parafernalia = panoplie, attirail, gadgets
paraguas     = parapluie
paraíso      = paradis
pardo        = léopard
pardo,a      = brun, sourd, sombre, gris
               mulâtre
paredón      = gros mur
               poteau d'exécution
pariente     = parent, proche parent
               moitié
parir        = mettre bas, accoucher
parlante     = parlant
parpadear    = cligner des yeux
               battre des paupières
               clignoter, scintiller
parpadeo     = papillotage
párpado      = paupière
parroquiano,a = client(e), paroissien(-ne)
pasaje       = passage, billet, passagers
pasajero,a   = passager, passant
pasamano     = galon, main courante
pasar        = passer, traverser
               transpercer
pasillo      = couloir
pasto        = paturage, pature
pastoso      = pateux
patada       = coup de pied
patán        = plouc, goujat, idiot
               paysan
patear       = donner des coups de pieds
               piétiner, siffler, huer
               laver la tête
               passer un savon, trépigner
               taper des pieds
patente      = manifeste, brevet, patente
               plaque, immatriculation
pátina       = patine
patinar      = patiner, déraper, gaffer
pautar       = régler, rayer
               tracer des portées sur (mus.)
pavor        = panique, effroi, épouvante
payaso       = clown
payo,a       = paysan, villageois
               campagnard
peana        = socle
pecoso,a     = criblé de tâches de rousseur
pedazo       = morceau
pedido       = commande
pedir        = demander, exiger, commander
pedir de boca (a) = merveille (à), parfaitement
               roulettes (comme sur des)
pedrada      = coup de pierre
pedradas (a) = coups de pierres (à)
pedregoso    = caillouteux, rocailleux
pegar (vi)   = prendre, aller, toucher
               heurter, taper
pegar (vtr)  = coller, frapper, battre
               donner, poser, passer
               pousser
peine        = peigne
pelar        = tondre, peler, éplucher
               plumer
peldaño      = marche, degré, échelon
pelear       = se battre, se disputer
pellejo      = peau
pelliza      = pelisse, dolman
pelota       = ballon, balle, boule
               lèche-bottes
pelotero     = fabricant
               ramasseur de balles
peltre       = étain, alliage étain-plomb
               métal blanc
penar        = punir, condamner à, peiner
penca        = feuille charnue
               raquette (nopal, agave)
pendejera    = ?
pendejo      = poil du pubis, froussard
               trouillard, crétin
               andouille, dépravé
pendiente    = pendant, suspendu
               en suspens, courant
               dépendre, être à la merci
               bouche d'oreille, pente
pene         = pénis
pensamiento  = pensée, esprit
peñazo,a     = emmerdeur, empêcheur
               casse-pieds
peón         = manœuvre, ouvrier agricole
               pion
peos         = ?
perdedor,a   = perdant(e)
perdido,a    = perdu, crade, perte, fuite
peregrinar   = aller en pélerinage
               voyager, errer
peregrino,a  = voyageur (-euse), bizarre
               drôle, étrange
pereza       = paresse
pericia      = dextérité, adresse
               habileté, savoir-faire
perilla      = bouc (barbe)
               point nommé (à)
perito       = expert, ingénieur technique
perjuicio    = préjudice, tort, atteinte
               perte
perol        = marmitte
perorar      = prononcer un discours
               pérorer
perra        = colère
               no tener una perra = ne pas avoir un rond
perro,a      = chien(ne)
perruno      = canin
perseguir    = poursuivre, rechercher
pertrechar   = équiper, munir, préparer
pertrechos   = attirail, équipement
pesadez      = lourdeur, ennui
pesadilla    = cauchemar
pesadumbre   = chagrin, ennui, tracas
pesar (a pesar de) = malgré
pesaroso,a   = peiné, désolé
pesimamente  = très mal
pésimo,a     = très mauvais
pesquería    = pêche, pêcherie
pesquisa     = recherche, enquête
petición     = demande, pétition
petición de (a) = demande de (à la)
pétreo       = pierreux
petulancia   = insolence, arrogance
pezón        = mamelon, queue (botanique)
piadoso,a    = pieux
picadura     = piqûre, morsure
               début de carie
picapleitos  = avocaillon
picaro,a     = coquin, malin, filou
               fripon, chapardeur
pico         = bec, coin, pointe, pic
piélago      = haute mer
pierna       = jambe, patte, cuisse, gigot
pila         = pile, évier, bénitier
pilleria     = bande de vauriens
               canaillerie, friponnerie
pinaza       = aiguille
pino         = pin
pintarrajear = barbouiller
piñazo       = peñazo ?, pinaza ?
pisada       = pas, empreinte, trace
               écraser le pied, écraser
pisar        = marcher sur, appuyer sur
               fouler, mettre les pieds à
               souffler, enlever, humilier
               rabaisser
pisotear     = piétiner, bafouer
pita         = Agave, fibre d'agave, bille
pitar        = siffler, arbitrer
               tirer sur
pito         = sifflet, bec, cigarette
               zizi, quequette
pitonisa     = voyante
pizarra      = ardoise, tableau
placentero   = agréable, plaisant
plagado,a    = infesté, rempli
plana        = face, page, une, plaine
               truelle, état-major
plano        = plat, plan
planta       = plante, usine, étage
               allure, apparence
plantar      = planter, plaquer, larguer
               mettre, poser
plantarse    = se coucher, faire face
               tenir tête, refuser
plantilla    = semelle
               personnel (employé)
plata        = argent, argentrerie
platanal     = bananeraie
plateado     = argenté
plazoleta    = petite place
plebeyo,a    = plébéien, personne vulgaire
plegar       = plier
pletórico    = plein (de)
pliegue      = pli (document)
plomo        = plomb, casse-pieds
               assommant
podar        = élaguer, tailler
poder        = savoir, pouvoir, supporter
               tenir
poderoso,a   = puissant(e)
podrido,a    = pourri, avarié, putride
               corrompu
poltrona     = bergère
polvo        = poussière
pólvora      = poudre
polvoriento  = poussiéreux
pómulo       = pommette
ponencia     = conférence, exposé
               communication, rapport
por aquello de que = c'est pour cela que
pordiosero,a = mendiant
pormenor     = détail
portada      = couverture, une (journal
               revue), façade
portar/se    = porter, se comporter
portátil     = portatif, portable
portón       = grande porte
pose         = pose, attitude
poseer       = posséder
poseían      = poseer
postrar      = incapaciter
postrarse    = se prosterner
postre       = dessert
postre (para) = pour couronner le tout
               par dessus le marché
postrer      = dernier, ultime
postrimerías = fin
postrimero,a = dernier, dernière
potencia     = puissance
potentizado  = ?
potestad     = puissance
pozo         = puits, défausse, pile, tas
pozuelo      = petit puits, jarre
pradera      = prairie
prado        = pré, pâturage, gazon
               pelouse
prebenda     = prébende, planque, sinécure
               privilège, passe-droit
predilecto   = préféré, de prédilection
predio       = propriété foncière
pregonar     = proclamer, rendre public
               crier sur les toits
               divulguer
prejuicio    = préjugé
premiar      = récompenser
prenda       = vêtement, drôle d'oiseau
               personne louche, gage
prendar      = plaire, charmer
prender      = attacher, accrocher
               allumer, prendre
prensa       = presse
prensar      = presser
prepotente   = arrogant, tout-puissant
presa        = proie, barrage
prescindir   = se passer (de)
               faire abstraction (de)
preso,a      = emprisonné
prestado     = prêté, emprunté, précaire
presunto,a   = présumé(e)
prima        = prime, chanterelle
primigenio   = primitif
primo,a      = cousin(e)
               poire (se faire avoir)
primorosamente = ?
primoroso,a  = ravissant, exquis, habile
prisa        = hâte
proa         = proue, nez
probar       = prouver, essayer, gouter
proeza       = prouesse
profesar     = professer, faire preuve de
               pratiquer
               prononcer ses vœux
profeta      = prophète
prófugo,a    = fugitif, déserteur
profuso      = abondant, profus
propenso,a   = sujet, enclin à
propiciar    = apaiser, favoriser
propósito    = intention, but, approprié
               propos (à)
prosapia     = lignée
prosequir    = poursuivre, continuer
prosopopeya  = prosopopée, affection
provecho     = profit, efficacité
proveedor    = fournisseur
provisto,a   = pourvu
proyectar    = projeter
proyecto     = projet
prueba       = preuve, épreuve, essai
               analyse
pudiendo     = poder
pues         = alors, parce que, car
puesta       = bien habillé, mise, ponte
pugna        = lutte, bataille, bagarre
               dispute
pugnar       = se battre, insister
pujante      = solide, robuste, dynamique
pulga        = puce
               tener malas pulgas = avoir mauvais caractère
pulimentar   = polir
pulsera      = bracelet
punzada      = piqûre
               élancement (douleur)
punzante     = pointu, lancinant
               caustique
puñado       = poignée, quelques
puño         = poing, poignet, poignée
               manchette
putear       = faire chier
               faire une vacherie

Q
quebrar      = casser, briser, plier
               pâlir, adoucir
               faire faillite
quehacer     = travail, tâche, boulot
quemado      = brulé, grillé
quemar       = brûler, fondre, griller
               cuire, vendre au rabais
               liquider
querer       = vouloir
queso        = fromage
quiebra      = effondrement, rupture
               faillite, fléchissement
               perte, chute
quienquiera  = quiconque
quimbambas   = les antipodes
quimbombó    = ?
quinientos   = cinq cents
quiosco      = kiosque
quiso        = querer
quitar       = voler, prendre, enlever
               oter, faire disparaitre
               nettoyer
quiten       = quitar

R
racha        = rafale (de vent), vague
raer         = racler, poncer, user
raido        = usé, élimé
raigambre    = racines, souche, tradition
raíz         = racine
raíz de (a)  = suite de (à la)
rancho       = ranch, grange, ferme
               banquet, festin, gamelle
rancio       = rance, ancien, aigri
               antipathique
rapar        = raser
rapiña       = rapine
rapiñar      = barboter
raro         = bizarre, rare, étrange
raro (fam.)  = homo, pédé
rascar       = gratter, racler
rasgar       = déchirer, gratter
rasgo        = trait, caractéristique
               acte
rastro       = trace, marché aux puces
               abattoir
rato         = moment
raya         = raie, rayure, pli, ligne
               limite, tiret
razia        = razzia
reabastecer  = abastecer
reacio       = réticent
rebajar      = baisser, diminuer, humilier
               rabaisser, descendre
rebanar      = couper, trancher
rebañar      = saucer, récupérer, gratter
rebeldía     = révolte, contumace
rebosar      = déborder
recabar      = récolter, réunir, récupérer
               faire valoir, revendiquer
               exiger
recado       = commission, message
recalar      = atterrir
recelo       = suspicion, méfiance
               soupçon
rechazar     = repousser, rejeter
recibo       = réception (action), reçu
               quittance
recio        = robuste, solide, fort
reclamo      = réclame, appeau
reclinar     = incliner
reclutamiento = recrutement
reclutar     = recruter, enrôler
               mobiliser
recoger      = ranger
recorrer     = parcourir, fouiller
recorrido    = parcours, itinéraire
recortado    = coupé, découpé
recortar     = couper, découper, réduire
recostar     = appuyer
recriminar   = récriminer
redicho      = chochotte, gnangnan, poseur
               pédant, redit
redil        = enclos
redimir      = racheter, libérer
redondo      = rond, catégorique, en or
reenfocar    = enfocar
referir      = rapporter
refiere      = referir
refinar      = raffiner, peaufiner
               affiner, polir
refino       = raffinage, affinage
               raffiné
reflujo      = reflux
refregar     = frotter, narguer
refriega     = rixe, bagarre, combat
               échauffourée
refulgente   = resplendissant
regalar      = offrir, flatter
regañadientes (a) = contre-cœur (à)
               rechignant (en)
regañar      = fâcher (se), disputer (se)
               fendre (se)
regar        = arroser, répandre
regentar     = tenir, être à la tête de
               diriger, régenter
registro     = registre, fouille
               perquisition
regusto      = arrière-gout, air
reir         = rire
relámpago    = éclair
relato       = rapport, récit
relieve      = relief, prééminent
rellano      = palier, replat
rellenar     = remplir, boucher, farcir
reluciente   = brillant
rematadamente = complètement, totalement
rematar      = achever, adjuger, liquider
               tirer au but (sport)
remitir      = expédier, remettre
               transmettre, renvoyer à
               s'apaiser, baisser
renacentista = de la Renaissance
renuente     = réticent, peu enthousiaste
               laborieux
reojo (de)   = du coin de l'œil
repentino,a  = soudain(e)
replegar     = replier
repleto (de) = plein
reporte      = rapport
repostar     = faire le plein
               s'approvisionner
requisito    = condition
resaca       = ressac, gueule de bois
resacoso     = ?
resaltar     = faire saillie, ressortir
               se distinguer
resbaladizo  = glissant, délicat
reseña       = signalement, compte-rendu
resequedad   = sequedad ?
resplandor   = éclat
restregar    = frotter
retaguardía  = arrière-garde, arrière
retazo       = coupon, chutes de tissu
               bribes, fragment, morceau
reto         = défi
retraer      = rétracter, se replier
retrasar     = retarder, reculer
               repousser, retarder de
retratar     = photographier
               faire le portrait de
               dépeindre
retribuir    = rétribuer
retroceder   = reculer
retroceso    = recul, aggravation
retumbar     = retentir, résonner, gronder
               tonner
reventar     = éclater, crever, se briser
               devenir fou, être furieux
               mourir d'envie de
               perturber, gâcher, saboter
revisar      = réviser
revoltijo    = fouillis, fatras, désordre
revolver     = remuer
               mettre sens dessus dessous
               fouiller, soulever le cœur
revuelto,a   = sens dessus dessous
               embrouillé, troublé
               instable, agité, soulevé
riachuelo    = ruisseau
ribera       = rive, rivage
rincón       = coin, recoin
rindar       = ?
riña         = rixe
riñon        = rein
risotada     = éclat de rire
ristre       = pieza de hierro de la armadura en la que se apoya la lanza
roble        = chêne (rouvre), roc
roce         = frottement, frôlement
               fréquentation, heurt, rozar
rociar       = asperger, semer, répandre
rocio        = rosée, pluie fine
               fine brume
rodaja       = tranche, rondelle
rodar        = rouler, dégringoler
               trainer, errer
rodear       = entourer, cerner
               faire le tour
rodilla      = genoux
rodillo      = rouleau, chariot
roer         = ronger, manger
rogar        = prier
roido        = rongé -> roer
rojizo       = rougeátre
romano,a     = romain
rompecabezas = puzzle, casse-tête
ron          = rhum
roncar       = ronfler
ronco        = enroué, rauque
roñoso,a     = crasseux, galeux, rouillé
               pingre, radin
ropero       = armoire, penderie, ouvroir
ropero,a     = vendeur(-se) (de vêtements)
               linger(ère)
rosal        = rosier
rostro       = visage
roto         = cassé, déchiré, brisé
               ereinté, homme
               femme du peuple, accroc
rotundamente = catégoriquement
rotundo,a    = catégorique, total(e)
rozar        = frôler, érafler, friser
               toucher
rueda        = roue, cercle, ronde
ruina        = ruine, décombre
               délabrement
ruino        = ?
ruinoso,a    = ruineux, en ruine
rumbo        = direction, cours, route
rutina       = routine

S
sabana       = savane
sábana       = drap
saber        = savoir, connaitre
               apprendre
sabiduria    = savoir, sagesse
sabihondo,a  = pédant(e), grosse tête
sabrían      = saber
sabroso,a    = délicieux(se)
               savoureux(se)
               intéressant(e)
               substantiel(le)
sacar        = sortir, tirer, résoudre
               gagner, rallonger, prendre
               passer, dépasser, arracher
saciar       = étancher, se rassasier
               assouvir, satisfaire
saco         = sac
sacudir/se   = secouer, battre, chasser
               se débarrasser
salao        = ?
salga        = salir
salir        = sortir, partir, décoller
salitre      = salpêtre
saltar       = sauter, bondir, rebondir
salvar       = surmonter, sauver
               sauvegarder, enregistrer
               empêcher
salvarse     = s'en sortir, échapper à
salvedad     = sauf (préposition)
               exception
salvo,a      = sauf(sauve)
sanguijuela  = sangsue
santería     = sainteté
               magasin d'objets religieux
sartén       = poêle, poêlée
sato         = ?
sazón        = assaisonnement
sazon (a la sazón de) = moment là (à ce)
secar        = sécher, essuyer
sediento,a   = assoifé, sec, avide
según        = selon, après (d')
               fur et à mesure que (au)
               fonction de (en)
selvatico    = boisé, des bois
sembrado,a   = semis, semé
sembrar      = semer, parsemer, couvrir
semilla      = graine, semence
semita       = sémite
sencillo     = simple
sendero      = sentier
sentido      = sens, sincère
               du fond du cœur
               susceptible, conscience
sentir       = sentir
seña         = signe, consigne, adresse
sequedad     = sécheresse
séquito      = cour, délégation, suite
               conséquence
seso         = cervelle, jugeotte
sien         = tempe
silbar       = siffler
silbato      = sifflet
sillón       = fauteuil
singón       = ?
sinsabor     = peine, ennui, tracas
sinsabores   = déboires, déconvenues
               revers
siquiera     = même si, au moins
soberanamente = souverainement
soberbio,a   = prétentieux, superbe
               énorme
sobornar     = soudoyer, acheter
               corrompre
soborno      = corruption, pot-de-vin
               dessous-de-table
sobra        = excédent, en trop
               sobras = restes (repas)
sobrante     = restant, excédent
sobre (el)   = enveloppe, sachet
               pieu (lit)
sobreponer   = superposer
sobreponerse = surmonter, s'imposer
sobresaltado = en sursaut
sobresaltar  = faire sursauter
sobrevenir   = survenir
sobrevino    = sobrevenir
socarrón,a   = sournois(e), narquois(e)
socarronería = sournoiserie
socio        = associé, membre, pote
soleado,a    = ensoleillé
solito       = solo ?
soltarse     = lacher, libérer, relacher
               défaire
soltura      = aisance
sonado,a     = retentissant, célèbre
               populaire, connu, dingue
               fou, timbré
sonoro       = sonore
sopapo       = claque
soplar       = souffler, gonfler, donner
               faucher
soporte      = support, soutien
sorber       = boire, absorber
sorna        = ton sarcastique
sortear      = tirer au sort, éviter
               surmonter
sosegar      = calmer
sostén       = soutien, soutien-gorge
sostener     = soutenir, tenir, entrenir
sótano       = sous-sol, cave
soterrar     = enterrer, enfouir, cacher
sublevación  = soulèvement
suceder      = arriver, se produire
               succéder à
sucedido     = suceder
sudar        = suer, suinter
               trempar de sueur
suelto       = suelto (monnaie)
suelto,a     = détaché, en monnaie
               unité (à l')
               sans consistance
               lâche (nœud), coulant, aisé
               relâché, désinvolte, déluré
suerte       = chance, sorte
sufrido      = patient, endurant
               non salissant
sufrir       = souffrir, supporter
sugerencia   = suggestion
sugerir      = suggérer
sumar        = additionner, s'élever à
               ajouter
sumo,a       = suprême, extrême
               a lo sumo = tout au plus
suponer      = supposer, présumer
               entrainer
               avoir comme conséquence
sureño,a     = du sud
surtir       = fournir, jaillir
suspicacia   = suspicion, méfiance
sustancioso  = substantiel, important
               riche
susto        = peur, effroi
susurrar     = chuchoter, susurrer
               murmurer
susurro      = chuchotement, murmure

T
tabicar      = cloisonner, obstruer
tabique      = cloison
tabletear    = claquer
tablón       = planche, plan d'eau
               panneau, plongeoir
taconear     = marcher
               faire du bruit avec ses talons
               claquer
               danser les claquettes
tajada       = tranche, cuite (ivresse)
tajado,a     = coupé, escarpé
tajante      = catégorique
tajar        = couper
tal vez      = peut-être
tamale       = ?
tamaño       = pareil (adj.), taille
               importance
tampoco      = non plus
tanda        = tour, groupe, tâche, série
               couche
tantear      = sonder, tâter, tâtonner
               examiner
tanteo       = tâtonnement, préemption
tapa         = couvercle, couverture
               talon, apéritif, portion
               bouchon
tapar        = couvrir, bouche, fermer
               cacher
tararear     = fredonner, chantonner
taza         = tasse, cuvette
teatino      = ?
teclado      = clavier
teclear      = taper
teja         = tuile
tejano,a     = texan, en jean
tejanos      = jean
tejer        = tisser, tresser, tricoter
tejida       = tissage, tissu
tela         = tissu, toile
temblar      = trembler
temblón      = tremblant
temer        = craindre
temido       = temer
temor        = crainte, peur
templar      = calmer, tremper, couper
               accorder, resserrer
tendedera    = ?
tendedero    = étendoir
tendido      = étendu, tendu
tensar       = tendre, énerver, stresser
tenso        = tendu, nerveux, stressé
tentar       = tenter, tester, tâter
tenue        = faible, ténu, futile
teñir        = teindre, nuancer, foncer
               teinter
terciar      = mettre en travers
               intervenir, interposer
terco,a      = têtu, entêté, borné
ternura      = tendresse, tendreté
terreno,a    = terrestre, terrain, domaine
tersura      = douceur
tertulia     = réunion entre amis, thé
               arrière-salle, cercle
               orchestre
tesca        = ?
testa        = tête, face
testar       = faire un testament
testarudo    = têtu
testigo      = témoin
tetilla      = mamelon, tétine
tétricamente = ?
tétrico,a    = lugubre
tiburón      = requin
tienta       = tienta (tauromachie)
tiento       = prudence, perche, balancier
               boire un coup
tierno,a     = tendre
tildado      = accentué, taxé de
timbal       = timbale
timbalú      = ?
tintinear    = tinter, cliqueter
               tintinnabuler
tintineo     = tintement
tiñe         = teñir
tipo         = type, nana
tira         = bande, lanière
               bande dessinée
tirar        = jeter, lancer, abattre
               tirer, étirer, renverser
               gaspiller
tirarse      = se jeter, s'étendre, tirer
               faire un plongeon
tiro         = tir, coup de feu, balle
               portée, tirage, entrejambe
               attelage, longueur, carrure
               jet, trait
Tiro         = Tyr
tirón        = crampe, vol à l'arraché
               dar un tirón = tirer
toalla       = serviette
tobillo      = cheville
tocino       = lard, sauts rapides
tocino de cielo = flan andalou
tolete       = tolet (nautic.), trique
tomar        = prendre, emprunter, couvrir
tomo         = tome (livre)
topar        = entrer en collision
               tomber sur
torbellino   = tourbillon
tornarse     = devenir
torneo       = tournoi
toro         = taureau, chariot élévateur
torpeza      = bêtise, maladresse
               gaucherie, gaffe, impair
               lourdeur
torreón      = bastion, donjon, tour
tórrido      = torride
tortellino   = ?
tose         = toser
toser        = tousser, s'en prendre à
               intimider
tozudo,a     = têtu
traer        = apporter, amener, rapporter
               causer
tragar       = avaler, engloutir, pomper
trago        = gorgée, verre
traicionar   = trahir
traicionero,a = traitre
trámite      = démarche, formalité
tramo        = tronçon, pan
trampa       = piège, trappe, dette
tramposo     = tricheur, mauvais payeur
trance       = mauvais pas, transe
transeúnte   = passant
               résident temporaire
               intérimaire, mobile
trapacero,a  = fraudeur, chicanier
traquetear   = crépiter, éclater, secouer
               tripoter
trasero,a    = arrière, derrière
trasiego     = transvasement, décuvage
trasladar    = déplacer, transporter
               muter, transférer
traspapelar  = égarer
traspasar    = transpercer, traverser
               franchir
trasquilado  = tondu, tonsure
trasquilar   = tondre
travesura    = espièglerie
trecho       = trajet, tronçon, portion
tremendamente = terriblement, énormément
tremendo,a   = terrible, énorme
trigueño,a   = couleur miel, châtain-clair
               auburn, métis, café au lait
triscar      = jouer, taper des pieds
               trépigner, tordre une dent
               emmêler
trizada      = trizar ?
trizar       = réduire en miettes
trocar       = échanger, troquer, changer
               évoluer, transformer
               trocart
trompada     = coup donné à une toupie
               marron (beigne)
               coup de poing, abordage
               collision
trompazo     = coup fort
trompear     = frapper, cogner
               bagarrer (se)
tronante     = ?
tronar       = tonner, résonner
troncho      = trognon
tronco       = tronc
tropezar     = se heurter à, s'opposer à
tropezarse   = tomber sur
tropezon     = faux pas, trébuchement
               morceaux de viande
               de nourriture
tropiezo     = incident, difficulté
               écart de conduite, faux pas
tropo        = trope (emploi d'un mot dans un sens figuré
               composition en musique médiévale)
trozo        = bout, morceau
trueno       = tonnerre, détonation
truhán       = truand
tumbar       = mettre par terre, renverser
               incliner, pencher, démolir
               abattre, étourdir
tupido,a     = épais, touffu
tupir        = rendre dense
turbio       = trouble, louche
turgencia    = turgescence
turiferario  = thuriféraire (ministre servant
               clerc, laique)
tuzao        = ?
tzatiqui     = tzatiki ? salade de comcombres au yaourt grec

U
ubicar       = placer, situer
ubicuo       = ubiquiste
               qui a le don d'ubiquité
ufano        = fier (personne)
               beau (plante)
ultrajante   = outrageant
umbral       = seuil
untar        = tartiner, enduire de
               étaler
uña          = ongle, griffe, sabot
urdir        = ourdir

V
vaciar       = vider, évider, dépouiller
               mouler
vacilar      = faire marcher, charrier
               tituber, chanceler, hésiter
vacio        = vide
vadear       = franchir à gué
vagar        = errer, flâner
vago         = vague, fainéant, paresseux
               clochard
vaharada     = bouffée
vaho         = vapeur
vajilla      = vaisselle
valedor,a    = protecteur, gardien
valioso      = précieux
valla        = haie, clôture
valle        = vallée
vallita      = valle
vanidad      = vanité, arrogance
vanidoso     = orgueilleux, fier, vaniteux
               présomptueux, vantard
               crâneur, fanfaron
vara         = tige, baton, pique
varón        = garçon, homme
vástago      = rejet, surgeon, rejeton
               descendance, tige, baguette
vejete       = viellot, vieux (vieille)
vela         = bougie, veille, voile
velada       = soirée, voilée, velar
veladamente  = ?
velador      = qui veille, veilleur
               chandelier, guéridon
velar        = vélaire, veiller, voiler
vello        = duvet
vencer       = vaincre, surmonter, battre
               mener
vencueto     = chemin scabreux, méandre
               détour
vendaval     = vent (violent)
vengativo,a  = vindicatif
ventaja      = avantage
ventanal     = baie vitrée
ventanilla   = vitre, fenêtre
ventoleja    = ?
ventolera    = bourrasque, rafale
               moulin à vent, grands airs
               idée saugrenue
vera         = bord
veraniego    = estival, d'été
verbena      = bal populaire, fête de rue
               kermesse, veillée, verveine
verborrea    = verbiage, verbosité
verbosidad   = verbosité
verja        = grille
verosímil    = vraisemblable, plausible
verter       = renverser, verser, traduire
               exprimer, débiter
               se jeter (à, dans)
vesania      = vésanie
vestidor     = dressing
vestir       = habiller, porter
viajado      = viajar
viajar       = voyager
vidrio       = verre, carreau
vidrioso     = vitreux, épineux, glissant
               fragile
vilo         = en l'air, en éveil
vilorta      = cerceau en bois, étançon
               clématite
vinculación  = lien
vincular     = lier, rendre inaliénable
vínculo      = lien
vindicar     = venger, défendre
               revendiquer
viruta       = copeau
vislumbrar   = entrevoir, percevoir
               deviner, discerner
               pressentir
víspera      = veille, vêpres
víspera (en .. de) = veille de (à la)
vista        = vue, yeux, regard, audience
               vestir
vistazo      = coup d'œil
viudo,a      = veuf, veuve
vivere       = vivir ?
vivere cauto = ?
viveres      = vivres, denrées
vivero       = pépinière, vivier
vocecilla    = ?
voladura     = explosion
volar        = faire sauter, voler
               s'évaporer
volcar       = renverser, se retourner
volver       = retourner, tourner, revenir
vomitivo,a   = vomitif
vuelta       = tour, retour, monnaie
               tournant, dos, revers

Y
yate         = yacht
yugo         = joug, fardeau

Z
zamarra      = blouson, fourré, pelisse
               peau de mouton, rustre
               pirate
zambullir    = plonger
zapato       = chaussure
zapatuo      = ?
zarpaso      = ?
zarpazo      = coup de griffe
zarrapastroso,a = négligé, en lambeaux
               clochard
zorrillesco  = ?
zozobrar     = chavirer, couler, sombrer
               faire du souci (se)
zueco        = sabot, chaussure plate
zumbar       = bourdonner, ronfler, filer
               flanquer, foutre
zumbarse a alguien = faire (se) (sexe)
               taper (se)
zumbón, ona  = moqueur, blagueur


--------FRANÇAIS -> ESPAGNOL--------------
A
a            = checo, a
abandon      = desvalimiento
abandonner   = dejar
abastecer    = reabastecer
abat-jour    = pantalla
abattage     = matanza
abattement   = desaliento
abattoir     = rastro
abattre      = derribar, derrumbar
               deshacer, desmoronar, tirar
               tumbar
abattre (personne) = hundir
abimer       = dañar, destrozar
abîmer       = estropear
aboiement    = ladrido
abominable   = ominoso
abondant     = profuso
abonder      = menudear
abordage     = trompada
aborder (figuratif) = enfocar
aboutir      = cuajar
aboyer       = ladrar
abri         = abrigo, cobijo
abriter      = guarecer
abrupt       = empinado
abrutir      = embotar
absence      = ausencia
absorbé      = enfrascado
absorber     = chupar, empapar, sorber
abus         = desmán
acariâtre    = esquinado, a
accablant    = abrazador, abrumador
accabler     = derrotar
accentué     = tildado
accomodant   = acomodaticio, a
accomplir    = cumplir
accorder     = afinar, templar
accoucher    = parir
accroc       = roto
accrochage   = golpe
accrocher    = prender
accueillir   = acoger
accumuler    = amontonar
acerbe       = áspero, a, displicente
acharné      = desaforado, a
acharnement  = empeño
acharner     = encarnizar
acheter      = sobornar
achever      = acabar, rematar
acier        = acero
acné         = barro
acquiescer   = asentir
acrimonieux  = displicente
acte         = rasgo
actif        = activo
actualités   = noticiario
adapter      = amoldar
additionner  = sumar
adieux       = despedida
adipeux      = adiposo
adjuger      = rematar
admettre     = asentir
adoucir      = quebrar
adresse      = pericia, destreza, seña
adroitement  = limpiamente
aducir (3e pers. sing. pret. ind.) = adujo
affaibli     = débil
affaiblir    = debilitar, entibiar
affaire      = asunto
affaire difficile = papeleta
affaires     = enseres
affection    = prosopopeya, cariño
affiche      = cartel
afficher     = ostentar
affiler      = aguzar
affinage     = refino
affiner      = afinar, aguzar, refinar
affirmation  = aseveración
affliger     = aquejar, compungir
affranchir   = franquear
affront      = feo
affrontement = choque
affronter    = enfrentar
affût        = acecho
affûtage     = afilado
a fondo = à fond = fondo
agave)       = penca
Agave        = pita
agenda       = carnet
agglutiner   = aglutinar
aggravation  = retroceso
agguerri(e)  = aguerrido, a
agir         = obrar
agissements  = desmán
agitation    = bullicio
agité        = revuelto, a
agneau       = cordero
agradecido   = malagradecido
agrafer      = coser
agréable     = placentero
agrès        = aparato
agresser     = agredir
agreste (rustique) = agreste
ahurissant   = asombroso
aide (à l'... de) = mediante
aigre        = displicente
aigre-doux   = agridulce
aigri        = rancio
aigu         = agudo, a, lacerante
aiguillage   = aguja
aiguille     = aguja, pinaza
aiguillette  = aguja
aiguillon    = espuela
aiguillonner = aguijonear
aiguisé      = afilado
aiguiser     = aguzar
ail          = ajo
aile (de moulin) = aspa
ail et piment = ajillo (al)
aimable      = amable
ainsi        = así
air          = regusto
aisance      = soltura
aisé         = suelto, a
ajourner     = aplazar
ajouter      = agregar, incorporar, sumar
ajustage     = ajuste
ajusté       = ceñido, a
ajuster      = acomodar, afinar, encajar
alcé         --> alzar = alce
alcôve       = alcoba
alimenter    = criar
allant       = empuje
allée        = avinguda (Catalan ?)
alléger      = aliviar
alléguer     = aducir
aller        = pegar (vi)
aller en pélerinage = peregrinar
aller se faire voir = carajo (irse al carajo)
alliage étain-plomb = peltre
allonger     = alargar
allumer      = alumbrar, prender, encender
allumette    = cerilla
allumettier  = fosforero, a
allure       = planta
allure (aspect) = estampa
alors        = pues, entonces
a lo sumo = tout au plus = sumo, a
altitude     = altura
amaigrir     = enflaquecer
amandier     = almendro
amasser      = amontonar
amateur de   = aficion
amateurs     = aficion
ambulant     = callejero
aménager     = acomodar
amener       = amainar, traer
amer         = amargo
amorcer      = entablar
analyse      = prueba
anarchiste   = acrata
ancien       = rancio
ancrage      = anclaje
ancré        = anclado
andouille    = pendejo
anéantir     = aniquilar
animal nuisible = alimaña
animation    = bullicio
animosité    = encono
anneau       = anilla
anneaux      = anilla
anneler      = anillar
annotation   = apunte
annuler      = dirimir
anormal      = anómalo, a
anse         = correa
antichambre  = antesala
anticiper    = anticipar
antipathique = rancio
apaiser      = aliviar, apaciguar
               propiciar
apercevoir   = divisar
apéritif     = tapa
aplomb       = aplomo
apostiller (mettre une apostille) = apostillar
apparaitre   = asomar
appareil     = aparato
apparence    = planta
appât        = carnada
appeau       = añagaza, reclamo
appel        = aviso
appeler      = avisar, llamar
appétissant  = apetecible
appétit      = ganas
application  = esmero
apporter     = traer
apprécier    = agradecer
apprendre    = saber
apprenti     = aprendiz
approcher    = avecinarse
approprié    = propósito
approvisionner = abastecer
appuyer      = recostar
appuyer sur  = apretar, pisar
après        = luego de
après (d')   = según
arabe        = moro, a
araignée     = araña
arbitrer     = pitar
archarné     = encarnizado, a
ardeur       = afán
ardoise      = pizarra
argent       = plata
argenté      = plateado
argentrerie  = plata
argile       = barro
argot        = jerga
arguer       = argüir
argumenter   = argüir
armes        = escudo
armoire      = ropero
armoire à glace = cristalera
arracher     = arrancar, arrebatar, sacar
arranger     = arreglar, componer, orillar
arrêt        = paradero, cese
arriéré      = atrasado
arrière      = retaguardía, trasero, a
arrière (à l') = atrás
arrière (en) = atrás
arrière-garde = retaguardía
arrière-gout = regusto
arrière-salle = tertulia
arriver      = acaecer, suceder
arrogance    = petulancia, vanidad
arrogant     = prepotente
arroser      = regar
articulation = juntura
artifice     = añagaza
artisan      = artesano
ascension    = ascenso
asile (d'aliénés) = manicomio
asperger     = rociar
aspérité     = aspereza
assaillir    = asaltar
assaisonnement = aliño, sazón
assaisonner  = aliñar
assassin     = asesino
asséner      = encasquetar
asseoir      = incorporar
assertion    = aseveración
assiéger     = asediar
associé      = socio
assoifé      = sediento, a
assommant    = plomo
assoupissement = modorra
assouplir    = mullir
assouvir     = saciar
assujettir   = asegurar
assurance    = aplomo
assurer      = asegurar, cerciorar
astucieux    = astuto, a
atroce       = horrendo, a
atrocité     = barbaridad
attacher     = atar, prender
attaguer     = atacar
attaquer     = agredir, asaltar
atteindre    = acertar, alcanzar
               conseguir
atteindre le bord = orillar
atteinte     = perjuicio
attelage     = tiro
attendre     = aguardar
attendrissant = entrañable
attenter     = atenter
atténuer     = aliviar
atterrer     = aterrar
atterrir     = recalar
attiédir     = entibiar
attirail     = parafernalia, pertrechos
attirer      = jalar, llamar
attitude     = actitud, pose
attraper     = agárrar, atrapar
attribuer    = adscribir, otorgar
attristant   = desolador
atusar       = atusó
atusó        = atuzó
auberge      = fonda
auburn       = trigueño, a
audience     = vista
audimat      = cuota
augmenter    = engrosar
augure       = agorero, a
augustin(e)  = augustino, a
au moins     = siquiera
aumône       = limosna
au plus profond de = hondo, a
aussi        = asimismo
automnal     = otoñal
automne de la vie (à l') = otoñal
automobile   = carro
autorail     = ferrobus
autoritaire et criarde) = marimacho
autre        = demás
autres (les) = demás
avalanche (literal & figurado) = alud
avaler       = tragar
avaliser     = avalar
avancement   = ascenso
avancer      = adelantar, anticipar
avant        = atrás
avantage     = conveniencia, ventaja
avant-garde  = avanzadilla
avare        = desventurado, a
avarié       = podrido, a
avec l'intention (con ... de) = ánimo
avec une sauce à base d'huile = ajillo (al)
avenue       = avinguda (Catalan ?)
averse       = aguacero, chaparrón
aversion     = inquina
averti       = enterado
avertir      = advertir
avertissement = advertencia, aviso
aveugle      = ciego, a
aveugler     = cegar
avide        = sediento, a
avis         = aviso
avocaillon   = picapleitos
avocat(fruit) = aguacate
avocatier    = aguacate
avoir        = cumplir
avoir comme conséquence = suponer
avoir cours  = correr
avoir du piston = cuña (tener)
avoir honte de = avergonzar, se
avoir lieu   = acaecer
avoir l'intuition de = intuir
avoir recours à = acudir
avoir un entretien = despachar
avouer       = confesarse

À
à part ça (por lo ..) = demás

Â
âgé          = otoñal
âge mûr (d') = otoñal
âne          = burro, a
ânesse       = burro, a
âpre         = áspero, a
âpreté       = aspereza

B
badge        = chapa
baffe        = guantazo
bafouer      = pisotear
bagarre      = pugna, bronca, choque
               refriega
bagarrer (se) = trompear
baguette     = vástago
baie vitrée  = ventanal
bâillement   = bostezo
bailler      = bostezar
bain         = caldo
baiser       = joder
baisser      = aflojar, bajar, rebajar
               remitir
bal          = baile
balai-serpillière = mocho
balance      = libra
balancer     = columpiar
balancier    = tiento
balançoire   = columpio
balayer      = barrer
balle        = pelota, bala, balazo, tiro
ballon       = pelota
ballot       = abarrote
balourd      = palurdo
bal populaire = verbena
bambin       = chiquillo, a
bananeraie   = platanal
bancal       = cojo, a
banc de sable = médano
bande        = atajo, lista, tira
bande (d'amis) = pandilla
bande dessinée = tira
bande de vauriens = pilleria
bannière     = bandera
banquet      = agasajo, rancho
baraqué      = macizo, a
bar à vin    = bodega
barbant      = latoso
barboter     = rapiñar
barbouiller  = pintarrajear
barrage      = presa
barrer       = barriendo
bassine      = jofaina
bastion      = torreón
bas trop larges = butifarra
bataille     = pugna
bâtard       = chucho
bateau-citerne = aljibe
bâtir        = obrar
bâtisse      = caserón
baton        = vara
battant      = hoja
batte        = pala
battre       = pegar (vtr), derrotar
               latir, sacudir, se, vencer
battre à plate couture = barrer
battre de l'aile = cojear
battre des paupières = parpadear
battu        = batido
bavardage    = charla
bavarder     = charlar
béat         = beato, a
beau-frère   = cuñado, a
beau gosse   = guyabo, a
beau (plante) = ufano
bébé         = guagua (América)
bec          = pico, pito
bêcher       = cavar
bégueule     = gazmoño (familier)
beignet      = buñuelo
belle étoile (à la) = intemperie
belle fille  = guyabo, a
belle-sœur   = cuñado, a
bénéfice     = conveniencia
bénéfices    = ganancias
bénignité    = levedad
bénin        = leve
bénitier     = pila
bercer       = acuñar
béret        = boina
bergère      = poltrona
bestseller   = éxito
bête         = bestia, burro, a
bête noire   = hueso
bêtise       = torpeza
béton        = concreto, hormigón
bibelot      = cursilería
bibliothèque = estante, librero
bibliothèques de périodiques = hemeroteca
bien accueillir = agasajar
bien choisir = acertar
bien faire   = acertar
bien habillé = puesta
Bienheureux  = beato, a
bien que     = aun
bigot        = beato, a
bille        = pita
billes       = bolitas
billet       = papeleta, pasaje
biner        = cavar
bizarre      = peregrino, a, estrafalario
               raro
blagueur     = burlón, zumbón, ona
blâmer       = increpar
blanchâtre   = blancuzco, a
blason       = escudo
blennie fluviatile = fraile
blessant     = lacerante
blessé       = herido
blesser      = dañar
blessure     = daño
bleu de travail = buzo
blouse       = bata
blouson      = zamarra
bluff        = farol
boire        = chupar, empapar, sorber
boire un coup = tiento
boisage      = maderamen
boisé        = selvatico
boiser en plein = macizar
boite        = caja
boîte        = cajetilla
boite (de conserve) = lata
boite postale = casilla
boiter       = cojear
boiteux      = cojo, a
boitier      = caja
bol          = cazo
bombance     = cuchipanda
bombe        = juerga
bon          = idóneo, a
bondé        = abarrotado, a
bondir       = saltar
bonne à tout faire = cenicienta
bonnet       = gorro
bord         = orilla, vera
bordel !     = carajo
border       = bordear, orillar
bordure      = jirón
borné        = terco, a
bosse        = bulto
botte (escrime) = estocada
bouc         = cabrón
bouc (barbe) = perilla
bouche       = tapar
bouche d'oreille = pendiente
bouchée      = bocado
boucher      = cegar, rellenar
bouchon      = corcho, tapa
bouclé       = ensortijado
boucle (ceinture) = hebilla
bouclier     = escudo
boudin catalan = butifarra
boudoir      = alcoba
boue         = barro, fango
bouffée      = vaharada
bouffer      = jalar
bougie       = vela
bougran      = entretela
boui-boui    = garito
bouillir     = hervir
bouillon     = caldo
bouillonner  = hervir
bouillotte   = bolsa
boulanger(ère) = panadero, a
boulangerie  = panadería
boule        = pelota
boulot       = quehacer
bourdonner   = zumbar
bourgeon     = brote, cogollo
bourrasque   = ventolera
bourrer      = atiborrar
bourse       = bolsa
bousculer    = apremiar
bout         = ápice, bocado, cabo, trozo
bout portant (à) = bocajarro, a
bracelet     = pulsera, correa
braillement  = ladrido
brailler     = ladrar
brandebourg  = alamar
brandir      = blandir
branlette    = paja (vulg.)
braquer      = empuñar, enfocar
brasseur (euse) = cervecero, a
bravache     = bravucón(a)
bravade      = guaperia
bredouiller  = atropellarse
bref         = breve
brevet       = patente
bribes       = retazo
brigadier    = cabo
brillant     = reluciente
briller      = luciar
brincar      = brinqué
bringuek     = juerga
brisé        = roto
briser       = desbocar, deshacer
               estrellar, quebrar
brouhaha     = algarada, bullicio
               guirigay
broussaille  = maleza
brulant      = abrazador
brulé        = quemado
brûle-pourpoint (à) = bocajarro, a
brûler       = arder, quemar
brûlure      = escozor
brumeux      = brumoso, a
brun         = pardo, a
brute        = bestia
bûcher       = hoguera
buisson      = mata
bulletin de notes = papeleta
bureau       = despacho, escritorio
bus          = guagua (América)
but          = propósito
butiner      = espigar

C
cabale       = cábala
cabot        = chucho
cache        = escondite
cache-cache  = escondite
cacher       = agazapar, esconder
               soterrar, tapar
cachette     = escondite, escondrijo
caddie       = carro
cadeau       = obsequio
café au lait = trigueño, a
cage thoracique = costillar
cahier       = cuaderno
cahots       = cabeceo
cailler (lait) = cuajar
caillouteux  = pedregoso
caisse       = caja, cajon
calcaire     = caliza
calculer     = calcular, computar
cale         = bodega, cuña
calicot      = manta
calme plat   = bonanza
calmer       = aliviar, apagar, sosegar
               templar
camelot      = buhonero, a
camelote     = chatarra
camp         = gremio
campagnard   = payo, a
campement    = campamento
camping      = campamento
canaillerie  = pilleria
canal        = cauce
canal)       = lecho
canaliser    = encauzar
candélabre (chandelier = candelabro
candide      = candoroso
canin        = perruno
caniveau     = arroyo, cuneta
canon        = despampanante
canot        = bote
caoutchouteux = correoso, a
cap          = cabo
cape         = capote
capituler    = capitular
caporal      = cabo
capote       = capote
capsule      = chapa
captiver     = cautivar
captivité    = cautividad
capturer     = cautivar
car          = pues
caractéristique = inconfundible, rasgo
carafe       = garrafa
carambolage  = choque
carapace     = concha
carcéral     = carcelero, a
cardigan     = chaqueta
carence      = ausencia
caresser     = acariciar
carnet       = libreta
carreau      = baldosa, vidrio
carreau de faïence = azulejo
carré (de viande) = costillar
carrefour    = encrucijada
carreler     = baldosar, losar
carrière     = carrera
carrure      = tiro
cartable     = cartera
carte (à jouer) = naipe
carte (identité = carnet
casaque      = casaca
case         = casilla
caserne      = cuartel
casier       = casilla
casque       = casco
casquette    = gorra
cassé        = roto
casse-pieds  = peñazo, a, plomo, lata
casser       = desbocar, quebrar
casserole    = cazo
casse-tête   = rompecabezas
catégorique  = redondo, rotundo, a
               tajante
catégoriquement = rotundamente
cauchemar    = pesadilla
causer       = criado, a, deparar, traer
causerie     = charla
caustique    = punzante
cautériser   = foguear
cautividad   = cautiverio
cave         = bodega, sótano
ce           = aquello, ese, a
céder        = ceder
ceder (1era persona imperfecto subjuntivo) = cediese
ceinture     = cintura, correa
ceinturer    = ceñir
cela         = aquello
ce ...-là    = ese, a
célèbre      = sonado, a
célébrité    = fama
celle-là     = ése, a
cellule      = celda
celui-là     = ése, a
cendre       = ceniza
cendré       = ceniciento, a
cendrier     = cenicero
cendrillon   = cenicienta
cerceau en bois = vilorta
cercle       = corro, rueda, tertulia
cercle (association) = ateneo
cercueil     = caja
cerner       = rodear
certificat   = fe
certitude    = certeza
cerveau      = cerebro
cervelle     = cerebro, seso
ces          = ese, a
ces ...-là   = ese, a
cessation    = cese
cesser de pleuvoir = escampar
c'est pour cela que = por aquello de que
cette        = ese, a
chagrin      = pesadumbre
chambre      = alcoba, cubículo
chance       = suerte
chanceler    = vacilar
chandelier   = velador
changer      = mudar, trocar
chanterelle  = prima
chantonner   = canturrear, tararear
chapardeur   = picaro, a
chapelle     = capilla
chapitre     = capítulo
charabia     = guirigay
charger (quelqu'un de quelque chose) = encargar
charion      = carro
chariot      = rodillo
chariot élévateur = toro
charité      = limosna
charme       = hechizo
charmer      = prendar
charrier     = vacilar
chasser      = ahuyentar, arrojar, sacudir
               se
chasteté     = castitad
châtain-clair = trigueño, a
chatte (vulgaire) = concha
chaudière    = fogón
chauffer     = calentar
chausse      = manga
chaussée     = calzada
chausser     = calzar
chaussette   = calcetin
chaussure    = zapato
chaussure plate = zueco
chavirer     = zozobrar
checoslovaco = checo, a
chef         = gallo
chemin       = derrotero
chemin de fer = ferrocarril
chemin scabreux = vencueto
chemise      = carpeta
chêne (rouvre) = roble
chêne vert   = encina
chèque       = cheque
cher         = entrañable
chercher à savoir = averiguar
chéri(e) !   = cariño
chevaleresque = caballeresco, a
cheveu blanc = cana
cheville     = tobillo
chevillette  = estaquilla
chevronné    = curtido, a
chevronné(e) = aguerrido, a
chicanier    = trapacero, a
chien(ne)    = perro, a
chier        = cagar
chiffonner   = arrugar
chiot        = cachorro
chochotte    = redicho
choisir      = escoger
chouette     = lechuza
chuchotement = susurro
chuchoter    = susurrar
chute        = quiebra
chutes de tissu = retazo
ciboulot     = azotea
cigare (marque) = caliqueño
cigarette    = pito
cinglé       = desquiciado
cinq cents   = quinientos
citation     = cita
citerne      = aljibe
clair        = claro, diáfano, nitido
clairière    = claro
claque       = manotazo, sopapo
claqué       = chupado, a
claquer      = tabletear, taconear
clarifier    = despejar
classer      = ordenar
classique    = consabido
clavier      = teclado
clébard      = chucho
clématite    = vilorta
clerc        = turiferario
client(e)    = parroquiano, a
cligner des yeux = parpadear
clignoter    = parpadear
cliqueter    = tintinear
clochard     = vago, zarrapastroso, a
clocher      = cojear
cloison      = tabique
cloisonner   = tabicar
clôture      = cerca, valla
cloué        = clavado
clouer       = clavar
clown        = payaso
cocasse      = chusco, a
cochon       = cerdo, cochino, a
cocu         = cabrón
cœur         = cogollo
coexister    = convivir
coffre       = baúl, caja
coffret      = estuche
cogner       = trompear
cohabiter    = convivir
coin         = pico, cuña, esquina, rincón
coin caché   = escondrijo
coincé       = cortado, a
coïncider    = coincidir
col          = cuello
colère       = perra
collation    = colación
colle        = cola
collègue     = colega
coller       = adherir, pegar (vtr)
colline      = loma
collision    = choque, trompada
colossal     = descomunal
colporteur   = buhonero, a
combat       = contienda, lidia, refriega
combattre    = atacar, lidiar
comble       = colmo
combler      = llenar
comédien     = farsante
comité de la police secrète = checa
commande     = pedido
commander    = pedir, encargar, mandar
commencer    = entablar
commencer à faire jour = amanecer
commerce au détail = detallismo
commettre    = cometer
commission   = recado
commissure   = comisura
commodité    = comodidad
commun       = afin(es)
communication = ponencia
communier    = comulgar
compère      = gancho
complaisance = agrado
complètement = rematadamente
complexe     = intrincado
compliment   = halago
compliqué    = intrincado
componer     = compuesta
comportement = actitud
composer     = componer
composition en musique médiévale) = tropo
compter      = computar
compte-rendu = reseña
comptoir     = mostrador
comte        = conde
comtesse     = condesa
con          = coño
conception   = diseño
concevoir    = alumbrar, concebir
               discurrir, diseñar
concierge    = conserje
concorder    = coincidir
concret      = concreto
condamner    = desahuciar
condamner à  = penar
condition    = requisito
conduire     = manejar
conduire à   = inducir
conduite     = actitud
conférence   = ponencia
conférer     = otorgar
confiance    = aplomo, fe
confitûre    = mermelada
conflit      = contienda
confondre    = equivocar
conformer    = conformar
confort      = comodidad
confrère     = colega
confrérie    = hermandad
confus       = enmarañado
confusion    = confusionismo
congé        = descanso, despedida
congédier    = despachar
conjecture   = cábala
conjecturer  = conjeturar
conjuguer    = aglutinar
con juicio   = juiciosamente
conjuration  = conjura
connaitre    = saber
connard      = cerdo
connerie     = gilipollez
connu        = sonado, a
consacrer    = consagrar
conscience   = sentido
conseiller   = aconsejar
conséquence  = séquito
consigne     = seña
consolation  = consuelo
consolider   = afianzar
consommé     = caldo
consommer    = gastar
conspiration = conjura
constater    = advertir
construire   = obrar
consuétudinaire (en rapport avec le droit coutumier) = consuetudinario, a
consumer     = carcomer
contaminer   = enfermar
conte        = cuento
contender    = contienda
contenir     = contener
conteur      = cuentista
contigu      = lindero, a
continuer    = prosequir
contour      = derredor
contracter   = encoger
contraindre  = apremiar
contraire    = ajeno
contraster   = contrastar
contre-cœur (à) = regañadientes (a)
contrit      = compungido, a
contumace    = rebeldía
convaincre   = arrastrar
convenance   = conveniencia
convenir de  = acordar
convive      = comensal
copeau       = viruta
coq          = gallo
coquille     = concha
coquin       = picaro, a
corbeille (bourse) = corro
cordage      = cabo
corde        = cuerda
coriace      = correoso, a
corporation  = gremio
corridor     = corredor
corriger     = corregir
corrompre    = estragar, sobornar
corrompu     = podrido, a
corruption   = soborno
cossard      = manta
costume      = indumentaría
côte         = cuesta
côté         = costado
cotisation   = cuota
cou          = cuello
couac        = gallo
couche       = lecho, tanda
coucher      = acostar(se)
coudre       = coser
couilles     = cojones
coulant      = suelto, a
couler       = correr, fluir, hundir
               zozobrar
couleur miel = trigueño, a
couloir      = pasillo
coup         = golpe
coup de feu  = balazo, disparo, tiro
coup de foudre = flechazo
coup de griffe = zarpazo
coup de langue = chupada
coup de main (donner un) = capote a alguien (echarle un)
coup de pied = patada
coup de pierre = pedrada
coup de poing = trompada
coup de queue = coletazo
coup d'œil   = vistazo
coup donné à une toupie = trompada
coupé        = aguado, a, recortado
               tajado
couper       = atajar, cortar, rebanar
               recortar, tajar, templar
couper court = desvanecer
couper court à = atajar
couper en quartier = cuartear
couper le pain en petit morceaux = migar
coup fort    = trompazo
coupon       = retazo
coup ou blessure de flèche = flechazo
coups de pierres (à) = pedradas (a)
coupure      = apagón
cour         = séquito
courage      = aliento, ánimo
cour (à la)  = cortesano
courant      = pendiente, corriente
cour (de là) = cortesano
coureur      = corredor
cour (faire la cour à) = corte (la)
courir       = correr
courrageux   = arrojado, a
courroie     = correa
cours        = cauce, rumbo
cours)       = desbocarse
course       = carrera
courtier     = corredor
courtisan    = cortesano, a
courtois     = cortesano, a
cousin(e)    = primo, a
cousu        = cosido, a
coûter       = costar
couture      = cosido
couvercle    = tapa
couverts     = cubertería
couverture   = portada, manta, tapa
couvre-lit   = colcha
couvrir      = abrigar, sembrar, tapar
               tomar
crachat      = escupitajo
cracher      = arrojar, escupir
crade        = perdido, a
craindre     = temer
crainte      = temor
crampe       = tirón
crâneur      = fantasmón, ona, vanidoso
crapaudine   = cebolla
craquer      = chasquear
crasseux     = roñoso, a
cratère      = hoya
cravate      = corbata
crayon       = lapiz
crème        = cogollo
crépiter     = traquetear
cresson      = berro
crétin       = pendejo
cretonne     = cretona
creuser      = cavar
creux        = hueco
crever       = reventar
crevette     = camarón
criblé de tâches de rousseur = pecoso, a
cri d'orfraie = graznido
crier sur les toits = pregonar
cris         = griterio
cristallin   = cristalino
critiquer    = atacar
croassement  = graznido
crochet      = gancho
croire       = calcular, creer
croisement   = encrucijada
croquis      = apunte
crotté       = embarrado
croupe       = culata
cuillérée    = cucharada
cuir         = cuero
cuire        = guisar, quemar
cuisant      = ceniciento, a
cuisiner     = guisar
cuisse       = pierna
cuite (familier) = curda
cuite (ivresse) = tajada
cuivre       = cobre
culasse      = culata
culminant    = álgido
culotte      = braga
cultiver     = labrar
cuvette      = hoya, taza

Ç
ça           = aquello

D
dalle        = baldosa, losa
daller       = baldosar, losar
dandy        = cajetilla
dans)        = verter
danser les claquettes = taconear
dar          = di
dard         = aguijón
dar un aventón a = déposer quelqu'un = aventón
dar un tirón = tirer = tirón
date (à cette) = altura (a estas)
dater        = fechar
débandade    = estampida
débarasser   = despejar
débiter      = espetar, verter
déboires     = sinsabores
débordement de joie = alborozo
déborder     = desbordar, rebosar
débroussailer = desbrozar
début        = atisbo
débutant     = aprendiz, novato
début de carie = picadura
de cartel = de renom = cartel
décédé       = malogrado
déchainer    = desatar
déchanter    = desengañar
décharge     = descargo
déchargement = descargo
décharger    = desfogar
décharné     = demacrado, escuálido, a
déchet       = deshecho
déchirant    = lacerante
déchiré      = roto
déchirer     = rasgar
déchirure    = desgarrón
décider      = acordar
decir        = di
décoller     = desprender, salir
décombre     = ruina
déconvenues  = sinsabores
décorer      = adornar, componer
               engalanar
de coup d'état = golpista
découpé      = recortado
découper     = recortar
décourageant = desalentador
découragement = desaliento, displicencia
décourager   = acobardar, desalentar
               desmoronar
découverte   = hallazgo
dêcrépi      = desconchado, a
décrocher    = atrapar, desenganchar
décuvage     = trasiego
dédaigner    = desdeñar
dédain       = desdén
deducir      = deduje
déduire      = deducir, descontar
de face      = frente
défaire      = deshacer, soltarse
défait       = deshecho
défaite      = derrota
défausse     = pozo
défection    = defección
défendre     = vindicar
déféquer     = corregir
défi         = reto
défier       = desafiar
déflagration = estampido
défunt       = malogrado
dégager      = arrojar, desempeñar
               despejar, desprender
               franquear
dégat        = daño
dégât        = estrago
de glace     = helado, a
déglingué    = destartalado, a
dégourdi     = listo, a
dégoùt       = asco
dégoût       = escrúpulo
dégoutant    = cochino, a
dégoùter     = asquear
degré        = peldaño
dégringoler  = rodar
déguenillé   = desharrapado
déguiser     = disfrazar
de haute lignée = alcurnia (de)
dehors       = intemperie
déjeuner     = almorzar, almuerzo
de la bière  = cervecero, a
délabré      = destartalado, a
               desvencijado
délabrement  = ruina
délaissement = desvalimiento
de la même manière = asimismo
de la Renaissance = renacentista
de la rue    = callejero
délayer      = desleír
délectation  = fruición
délégation   = séquito
déléguer ses pouvoirs à = apoderar
délibéré     = delibarodo, a
délicat      = escabroso, resbaladizo
délicieux(se) = sabroso, a
délier       = desatar
délirer      = alucinar
délivrer     = librar
déloyauté    = deslealtad
déluré       = suelto, a
demande      = petición
demande de (à la) = petición de (a)
demander     = pedir
demander conseil à = aconsejarse
démantibulé  = destartalado, a
démarche     = gestión, trámite
démarrer     = arrancar
de mauvais augure = agorero, a
de même      = asimismo
démesuré     = desaforado, a
démolir      = derribar, derrumbar, tumbar
démotivant   = desalentador
dénoncer     = delatar
dénouement   = desenlace
de nourriture = tropezon
denrées      = viveres
densité      = espesura
dentelle     = encaje
dépassé      = decimonónico
dépasser     = adelantar, asomar
               desbordar, sacar
dépecer      = cuartear, despellejar
dépêche      = despacho
dépeindre    = retratar
dépendre     = pendiente
dépenser     = gastar
dépit        = despecho
déplacé      = extemporáneo, a
déplacer     = trasladar
de plaisance = deportivo, a
déplaisant   = displicente
de plein droit = nato, a
déplorable   = lastimoso, a
déplorer     = lamentar, se
déposer      = depositar, ingresar
dépouillé    = escueto
dépouillement du scrutin = escrutinio
dépouiller   = despellejar, despojar
               estrujar, vaciar
dépravé      = pendejo
de prédilection = predilecto
dépression (du terrain) = hondonada
déraciner    = arrancar
déranger     = hostigar, molestar
déraper      = patinar
dériver      = derrotar
dernier      = postrer, postrimero, a
dernière     = postrimero, a
derrière     = atrás, trasero, a
désaccord    = discrepencia
désagréable  = displicente
désastreux   = desastroso
des bois     = selvatico
descendance  = vástago
descendre    = bajar, rebajar
déserteur    = prófugo, a
désespérant  = desesperanzador, a
désherber    = desbrozar
désinvolte   = suelto, a
désir véhément = afán
désolant     = desolador
désolé       = pesaroso, a
désordre     = revoltijo
désosser     = destripar
dès que      = apenàs
dessein      = designio
desserrer    = aflojar
dessert      = postre
dessin       = diseño
dessinner    = diseñar
dessous      = foso
dessous-de-table = soborno
dessous (les) = entresijos
dessus       = encima
destituer    = desaforar
d'Estrémadure = extremeño, a
destructeur  = asolador
détaché      = suelto, a
détacher     = desatar, desprender
               destacar
détail       = pormenor
d'été        = veraniego
dételer      = desenganchar
détenir      = ostentar
détériorer   = destrozar
détester     = odiar
détonation   = estallido, estampido
               trueno
détour       = vencueto
détremper    = encharcar
détruire     = destrozar
détruit      = deshecho
dette        = trampa
devant       = frente
dévastateur  = asolador
dévaster     = arrasar, asolar
devenir      = criado, a, tornarse
devenir calleux = encallecer
devenir fou  = reventar
dévider      = aspar
devin        = agorero, a
deviner      = acertar, barruntar
               vislumbrar
dévoiler     = desvelar
dévot        = beato, a
dextérité    = pericia
diaphane     = diáfano
dicerner     = divisar
difficile    = chupado, a
difficulté   = tropiezo
diffuser     = desprender, difundir
dignitaire   = jerarca
dignité      = maestrazgo
dilaté       = dilatado, a
dilater      = dilatar
dilemme      = disyuntiva
dimension    = medida
diminuer     = escatimar, rebajar
diner        = cenar
dingue       = sonado, a
dire         = llamar
directeur de prison = alcaide
direction    = rumbo
dire du mal (de qqn) = despellejar
dirigeant    = jerarca
diriger      = enfocar, regentar
discerner    = vislumbrar
discours     = charla
disparaitre  = dervanecerse, esfumarse
dispenser (un cours) = impartir
dispersé     = desperdigado
dispositif   = aparato
dispute      = pugna
disputer (se) = regañar
dissiper     = despejar, desvanecer
distinguer   = atisbar
dithyrambe (cantique = ditirambo
divergence   = discrepencia
divertissement = ocio
divination   = cábala
diviser      = cuartear
divulguer    = pregonar
doctrine     = ideario
dolman       = pelliza
domaine      = terreno, a
domestique   = criado, a
dommage      = daño, lástima
donjon       = torreón
donné        = dado
donner       = pegar (vtr), dar, empeñar
               impartir, soplar
donner chaud = acalorar
donner des coups de pieds = patear
donner du mou = aflojar
donner libre cours à = desfogar
donner son aval à = avalar
donner un nom = llamar
dont le      = cuyo, a
dos          = espalda, lomo, vuelta
dossier      = expediente
doubler      = adelantar
doucement    = despacio
douceur      = tersura
douleur      = daño, dolencia
douter       = dudar
douteux      = dudoso
doux         = apacible
draguer      = insinuar
drainer      = achicar
drap         = sábana
drapeau      = bandera
dresser      = adiestrar, erguir
dressing     = vestidor
drôle        = peregrino, a
drôle d'oiseau = prenda
drôlerie     = gracia
du 19ème siècle = decimonónico
du coin de l'œil = reojo (de)
du fond du cœur = sentido
du livre     = librero
dune         = médano
d'une seule traite = aliento
durcir       = encallecer
du sud       = sureño, a
duvet        = vello
dynamique    = pujante

E
e            = canoso, a, descreído
effacé (à moitié) = borroso, a
effacer      = borrar, desvanecer
effets personnels = enseres
efficacité   = provecho
effilé       = afilado
effondrement = quiebra
effort       = desvelo
efforts      = afán
effrayer     = asustar, aterrar
effroi       = pavor, espanto, susto
effronté     = atrevido, descarado
elle         = ése, a
embarquer    = desbocarse
embaumeur    = embalsamador
emboîter     = encajar
embrocher    = espetar
embrouillé   = enmarañado, revuelto, a
embrouiller  = enredar
embusqué     = emboscado, a
embusquer    = emboscar
emmêlé       = enmarañado
emmêler      = enmarañar, enredar, triscar
emmerdé      = jodido (vulgar)
emmerder     = joder, moler
emmerdeur    = peñazo, a
empêcher     = salvar
empêcher de dormir = desvelar
empêcheur    = peñazo, a
empester     = heder
emphatique   = enfático
emphysème (médecine : gonflement cellulaire ou pulmonaire) = enfisema
empoigner    = atenazar, empuñar
empoisonner  = envenenar
empreinte    = pisada
emprisonné   = preso, a
emprunté     = prestado
emprunter    = tomar
en bataille  = enmarañado
encadrer     = ceñir
encaissement = cobro
encaisser    = cobrar, encajar
encastré     = empotrado
enchanteur   = mago, a
enchevêtrer  = enmarañar
enclin à     = propenso, a
enclos       = redil
en coin      = esquinado, a
en contact   = lindar
encourager   = alentar
en détail    = extenso, a
endommager   = castigar
endroit      = paradero
enduire de   = untar
endurance    = aguanté
endurant     = sufrido
endurcir     = encallecer
en état d'ivresse = etílico
en éveil     = vilo
enfant de chœur = monago, monaguillo
enfanter     = alumbrar
enfermer     = encerrar
enflammer    = enardecer, encender
enfocar      = reenfocar
enfoiré      = cabrón, cerdo
enfoncer     = hundir
enfoncer sur la tête = encasquetar
enfouir      = soterrar
engager      = empeñar, entablar
engager à (s') = obligar, se
engloutir    = engullir, tragar
engourdissement = modorra
en haillons  = desharrapado, harapiento
en jean      = tejano, a
enjôler      = envolver
enlacer      = estrujar
en l'air     = vilo
en lambeaux  = zarrapastroso, a
enlevé       = chupado, a
enlever      = arrancar, pisar, quitar
en miettes   = deshecho
en monnaie   = suelto, a
ennui        = pesadez, pesadumbre
               desazón, sinsabor
ennuyer      = aburrir, se
en or        = redondo
en pincer pour (estar colado por alguien) = colado, a
en plus      = encima
enquête      = pesquisa, expediente
enrayer      = atajar
enregistrer  = grabar, salvar
enrôler      = reclutar
enroué       = ronco
enrouler     = envolver
en ruine     = ruinoso, a
ensoleillé   = soleado, a
ensorceler   = hechizar
ensorcellement = hechizo
en sursaut   = sobresaltado
en suspens   = pendiente
entamer      = entablar
entasser     = amontonar
enterrement  = entierro
enterrer     = soterrar
entêté       = terco, a
enthousiaste = furibundo, a
entourer     = ceñir, rodear
entracte     = descanso
entrain      = empuje
entrainer    = arrastrar, suponer
entraîner    = adiestrar
entrañablemente = entrañable
entrejambe   = tiro
entremêlé    = entreverado
entrenir     = sostener
entrepreneur = empresario, a
entrer dans  = abrazar
entrer en collision = topar
entretaille  = entretela
entrevoir    = atisbar, divisar
               vislumbrar
en trop      = sobra
enveloppe    = sobre (el)
envelopper   = envolver
envenimer    = envenenar, enzarzar
envie        = gana, ganas
envoi        = despacho
envolé       = empinado
envoûtement  = hechizo
envoûter     = hechizar
envoyer      = mandar
ereinté      = roto
ergot        = espolón
errer        = peregrinar, rodar, vagar
escarmouche  = escaramuza
escarpé      = empinado, tajado, a
escompter    = descontar
escorter     = escoltar
espièglerie  = travesura
esplanade    = explanada
esprit       = pensamiento, mente
esquisse     = apunte
esquiver     = burlar, eludir
essai        = prueba, ensayo
essayer      = probar
essence      = esencia
essentiel    = esencia
essorer      = estrujar
essuyer      = encajar, secar
estampe      = estampa
estival      = veraniego
estocade     = estocada
estompé      = difuminado
estomper     = esfumar
ethylique    = etílico
euphémique   = eufemístico, a
euse         = fantasmón, ona, mentiroso
               a
examen       = escrutinio
examiner     = tantear
excédent     = sobra, sobrante
excellent    = estupendo, a
exception    = salvedad
excès        = desmán
exclure      = desaforar
excuse       = descargo
exécuter     = cumplir
exercer      = adiestrar, desempeñar
exhaler      = espirar
exhorter     = conminar
exiger       = pedir, recabar
expédier     = despachar, remitir
expérimenté  = curtido, a
expert       = perito, enterado
expirer      = cumplir, espirar
exploser     = estallar
explosion    = estallido, estampido
               voladura
exposé       = ponencia, disquisición
exprimer     = verter
exquis       = primoroso, a, esquisito
               exquisito
exterminer   = aniquilar
extrême      = sumo, a
extrémité    = ápice

É
éblouissant  = deslumbrante
ébranler     = conmover
écaille      = concha, escama
écaillé      = desconchado, a
écaillure    = desconchado
écart de conduite = tropiezo
écarter      = apartar
échange      = canje
échanger     = canjear, trocar
échapper à   = salvarse
échauffer    = acalorar
échauffourée = refriega
échec        = derrota, fracaso
échecs       = ajedrez
échelle      = carrera
échelon      = peldaño
échine       = lomo
échouer      = encallar, fracasar
éclair       = relámpago
éclaircie    = claro
éclaircir    = despejar
éclairer     = alumbrar
éclat        = destello, resplandor
éclat de pierre = lasca
éclat de rire = risotada
éclater      = estallar, reventar
               traquetear
écœurer      = hostigar
économe      = ceñido, a
économiser   = ahorrar
écoper       = achicar
écorcher     = desollar, despellejar
écorné       = mocho, a
écoulement   = chorreo, chorreón
écouler (fausse monnaie) = colar
écran        = pantalla
écraser      = aplastar, pisada
écraser le pied = pisada
écrir        = escribir
écriture     = letra
écroulement  = desplome
écu          = escudo
écume        = espuma
également    = asimismo
égarer       = traspapelar
égout        = alcantarilla
égratigner   = arañar
égyptien     = egipcio
élaguer      = podar
élan         = alce, impetu
élancé       = espigado, a
élancement (douleur) = punzada
élevé        = criado, a
élever       = alzar, criar
élimé        = raido
éloge        = halago
éloignement  = lejanía
éloigner (s') = alejar(se)
émacié       = demacrado, escuálido, a
émettre      = librar
émettre un son (musique) = impostar
émeute       = jarana
émoussé      = mocho, a
émousser     = embotar
émouvant(e)  = conmovedor(a)
émouvoir     = conmover
énergie      = impetu
énerver      = despechar, tensar
énorme       = descomunal, ingente
               soberbio, a, tremendo
énormément   = tremendamente
épais        = espeso, grueso, a, tupido
épaisseur    = espesura, grueso
épaissir     = engrosar, espesar
épargner     = ahorrar, escatimar
éparpillé    = desperdigado
éparpiller   = desperdigar
épatant      = despampanante, estupendo, a
épater       = alucinar
épaule       = hombro
éperon       = espuela
éperon (d'un bateau) = espolón
éperonner    = espolear
éphémère     = efímero, a
épicerie     = bodega
épicerie (amérique) = abarrote
épier        = espigar
épine        = aguijón
épineux      = vidrioso
épingler     = clavar
éplucher     = pelar, despellejar
éponger      = empapar
épouser      = abrazar
épouvantable = desaforado, a, espantosa
épouvante    = pavor
épouvanté    = despavorido, a
épouvanter   = espantar
épreuve      = prueba, castigo
éprouver     = contrastar
épuisant     = abrumador
épuisé       = agotado, chupado, a, molido
épuiser      = apurar, moler
équipement   = pertrechos
équiper      = pertrechar
érafler      = arañar, rozar
éreinté      = chupado, a, molido
éreinter     = moler
éruption     = brote
étable       = establo
étage        = planta
étagère      = estante
étagères     = estanteria
étai         = estante
étain        = peltre
étaler       = ostentar, untar
étancher     = apagar, saciar
étançon      = vilorta
étang        = estanque
étape        = jornada
état-major   = plana
éteindre     = apagar, desvanecer
étendoir     = tendedero
étendu       = extenso, a, tendido
étêté        = mocho, a
étirer       = estirar, tirar
étoile filante = fugaz
étonnant     = extraño, a
étonnement   = asombro
étonner      = asombrar
étouffer     = ahogar
étourdir     = tumbar
étrange      = peregrino, a, extraño, raro
étranger     = ajeno, extraño, a
étrangler    = ahogar
étriper      = destripar
étroit       = angosto
études       = carrera
étui         = estuche
éveiller     = despertar
évènement    = acontecimiento
éventer      = abanicar
évider       = vaciar
évier        = pila, fregadero
éviter       = eludir, sortear
évoluer      = trocar
évoquer      = aludir, apuntar

Ê
être         = obrar
être admis   = ingresar
être agréable = agradar
être à la merci = pendiente
être à la tête de = regentar
être bancal  = cojear
être bordé   = lindar
être contigu = lindar
être d'accord = coincidir
être dans l'attente de = aguardar
être dans le coup = ajo (estar en el ajo)
être en contact = lindar
être en tête de = encabezar
être épaté   = bizquear
être furieux = reventar
être partant = apuntarse
être payé    = cobrar
être proche  = avecinarse
être surpris(e) par = atacar

F
fabricant    = pelotero
fabricant ou vendeur de poix = empecinado
façade       = portada, fachada
face         = plana, cara, faz, testa
faché        = molesto, a
fâcher (se)  = regañar
faciliter    = agilizar
façon        = guisa
façonnage    = ajuste
façons       = ademán
fade         = inocuo, insulso, a
fadeur       = desazón
faible       = débil, escaso, flojo, a
               tenue
faiblir      = amainar, desfogar, flaquear
faïence      = loza
faillite     = quiebra
faim         = hambre
fainéant     = manta, vago
faire        = cumplir, echar, librar
               obrar
faire abstraction (de) = prescindir
faire allusion à = aludir
faire appel à = acudir
faire asseoir = acomodar
faire attention = fijarse
faire bouillir = hervir
faire briller = abrillantar
faire cadeau = obsequiar
faire chier  = putear, joder, moler
faire claquer = chasquear
faire croire à = colar
faire des avances = insinuar
faire des bêtises = enredar
faire des efforts = esforzar
faire des trous = agujerear
faire disparaitre = desvanecer, quitar
faire du bruit avec ses talons = taconear
faire durer  = dilatar, estirar
faire du souci (se) = zozobrar
faire ébouler = desmoronar
faire échouer = estropear
faire entrer = encajar, ingresar
faire face   = plantarse
faire faillite = quebrar
faire fondre = deshacer
faire fuir   = ahuyentar, espantar
faire glisser = deslizar
faire grossir = engrosar
faire honte  = avergonzar, se
faire la mise au point de = enfocar
faire le plein = repostar
faire le portrait de = retratar
faire le tour = rodear
faire maigrir = enflaquecer
faire mal    = dañar, molestar
faire marcher = vacilar
faire-part   = esquela
faire peur à = acobardar, asustar
faire plaisir = complacer
faire preuve de = profesar
faire ressembler à = asemejar
faire rétrécir = encoger
faire saillie = resaltar
faire sauter = volar
faire semblant = fingir
faire ses adieux = despedir
faire (se) (sexe) = zumbarse a alguien
faire son devoir = cumplir
faire sortir de ses gonds = desquiciar
faire sursauter = sobresaltar
faire tiédir = entibiar
faire une scène (armar la ..) = gordo, a
faire une vacherie = putear
faire un plongeon = tirarse
faire un tenon = espigar
faire un testament = testar
faire valoir = recabar
fair-play    = deportivo, a
fait         = acontecimiento
fait main    = hechizo, a
fait maison  = hechizo, a
fanal        = farol
fanfaron     = bravucón(a), vanidoso
fans         = aficion
fantôme      = espanto
farcir       = rellenar
fardeau      = lastre, yugo
farouche     = huraño, a
fasciner     = arrebatar
fatiguer     = hartar, moler
fatique      = cansancio
fatras       = revoltijo
faucher      = soplar
fauteuil     = butaca, sillón
faux         = falso, a
faux pas     = tropezon, tropiezo
favoriser    = propiciar
feindre      = fingir
feinte       = pamema
femme du peuple = roto
fendre (se)  = regañar
fenêtre      = ventanilla
fer          = hierro
ferme        = estancia, rancho
ferme (en catalogne) = masía
fermer       = deshacer, tapar
ferraille    = chatarra
fervent      = furibundo, a
fesse        = nalga
festin       = agasajo, rancho
fête         = baile, butifarra
fête de rue  = verbena
fêter        = agasajar
feu          = farol
feu de joie  = hoguera
feuillage    = follaje
feuille      = hoja
feuille charnue = penca
feuilleter   = hojear
fibre d'agave = pita
fidèle       = fiel, fijo, a
fier         = vanidoso
fier (personne) = ufano
figure       = figura, mito
fil          = hilo
file         = fila
filer        = aflojar, zumbar
filet        = chorreón, chorro, hilo
filet de lumière = atisbo
filleul      = ahijado, a
filou        = picaro, a
filtre       = cebolla
filtré       = colado, a
filtrer      = colar
fin          = agudo, a, paradero
               postrimerías, delgado
fine brume   = rocio
finir        = acabar, apurar
fixe         = fijo, a
fixer        = adherir, adscribir, fijar
fixer (yeux) = clavar
flacon       = frasco
flageoler    = flaquear
flambée      = llamarada
flamber      = llamear
flamber (prix = desbocarse
flamme       = llama
flan andalou = tocino de cielo
flanc        = costado, costillar, ladera
flâner       = vagar
flanquer     = zumbar
flapi        = molido
flaque d'eau = charco
flasque      = fláccido, a, flácido
flatter      = halagar, regalar
flatterie    = halago
flatteur     = halagador
flatulence   = flatulencia
flatulent    = flatulento
fléchissement = quiebra
flegme       = flema
flemmard     = manta
flirter      = lindar
flot         = chorreo, chorro
flot (à)     = flote
flottage     = flote
flotter      = flotar
flou         = borroso, a, desvaído
foi          = fe
foie         = hígado
foin         = paja
foire        = butifarra, juerga
folie        = locura
foncé        = oscuro, a
foncer       = teñir
fonction de (en) = según
fond         = fondo
fondations   = fundamento
fondement    = fundamento
fond (lac    = lecho
fondre       = quemar
force        = fortaleza, impetu
forcer       = esforzar
forger       = forjar
forgeron     = forjador
forgeur      = forjador
formalité    = trámite
former un coin = esquinar
fort         = agudo, a, recio
forteresse   = fortaleza
fortuit      = casual
fosse        = fosa, foso, hoya
fossé        = cuneta, foso
fou          = desquiciado, sonado, a
fouetter     = azotar
fougue       = impetu
fouille      = registro
fouiller     = hurgar, recorrer, revolver
fouillis     = revoltijo
foulard      = pañuelo
fouler       = pisar
fourbe       = alevoso, a
fourneau     = fogón
fournir      = surtir
fournisseur  = proveedor
fourré       = espesura, matorral, zamarra
foutre       = zumbar
foutre en l'air = cagar
foutu        = jodido (vulgar)
foyer        = brote
fracas       = fragor
fracasser    = estrellar
fragile      = lánguido, vidrioso
fragment     = retazo
frais        = cuota
franchir     = franquear, traspasar
franchir à gué = vadear
frange       = alamar
frapper      = acuñar, azotar, pegar (vtr)
               calentar, castigar, golpear
               trompear
fraternité   = hermandad
fraudeur     = trapacero, a
frayeur      = espanto
fredonner    = canturrear, tararear
freiner      = entibiar, frenar
frémissement = estremecimiento
frêne        = fresno
fréquentation = roce
frère        = fraile
fripon       = picaro, a
friponnerie  = pilleria, bellaquería
friser       = bordear, rozar
froideur     = displicencia
froisser     = arrugar, estrujar
frôlement    = roce
frôler       = bordear, rozar
fromage      = queso
fromage bleu des asturies = cabrales
fromager     = ceiba
froncer      = arrugar
fronde       = honda
front        = frente
frontière    = linde
frottement   = roce
frotter      = refregar, restregar
froussard    = pendejo
fugace       = fugaz
fugitif      = prófugo, a
fuite        = perdido, a
fumant       = humeante
fumée        = chupada
fur et à mesure que (au) = según
furibond     = furibundo, a
furieux      = furibundo, a
fusil (de chasse) = escopeta
futile       = tenue

G
gaché        = aguado, a
gâcher       = reventar
gâcher (platre) = amasar
gadgets      = parafernalia
gaffe        = gafa, torpeza
gaffer       = patinar
gaga         = chocho, a
gage         = prenda
gagé         = empeñado
gagner       = sacar
galeux       = roñoso, a
galicien     = gallego, a
galion       = galeón
galon        = pasamano
gamelle      = rancho
gamin        = chiquillo, a
garçon       = varón
garde        = custodia
gardien      = conserje, valedor, a
gardien de prison = carcelero, a
garnir d'anneaux = anillar
gaspiller    = tirar
gâter        = estragar
gâteux       = chocho, a
gaucherie    = torpeza
gaver        = hartar
gazeux       = gaseoso, a
gazon        = prado
gelé         = helado, a
gemir        = gemir
gemir (3° pers. sing. ind. y 2° pers. sing. imper.) = gime
gênant       = molesto, a
gencive      = encía
gêne         = apuro, lastre
gêner        = apurar, estorbar, hostigar
               molestar
Genève       = Ginebra
genoux       = rodilla
geôlier      = carcelero, a
gercé        = cortado, a
gérer        = manejar
geste        = ademán
gestion      = gestión
giclée       = chorreón
gifler       = abofetear
gigot        = pierna
gilet        = chaleco
gin          = ginebra
glace        = helado
glacé        = helado, a
glacial      = álgido
gland (insigne) = borla
glaner       = espigar
glissant     = resbaladizo, vidrioso
glissement   = deslizamiento
glisser      = colar, deslizar
gloire       = lauro
gloutonnerie = gula
gnangnan     = redicho
gobelet      = cubilete
gommer       = borrar
gonfler      = soplar
gorge        = garganta
gorgée       = trago
gosse        = chiquillo, a
gouache      = aguada
goujat       = patán
goulet       = cuello
gourde       = cantimplora
gout         = gracia
goût         = aficion
gouter       = probar
goûter       = chupada
goutteux     = gotoso, a
goyave       = guyabo, a
goyavier     = guyabo, a
grabuge      = jarana
grâce        = gracia
grâce à      = mediante
graine       = semilla
grande porte = portón
grand fauteuil = butacón
grandiloquent = enfático
grandir      = criado, a
grands airs  = ventolera
grange       = rancho
grapiller    = arañar
gras         = gordo, a [adj]
gratter      = rascar, rasgar, rebañar
grave        = agudo, a
graver       = grabar
gravure      = grabado
grenier      = granero
grenier à paille = pajar
gribouiller  = garabatear, garrapatear
griffe       = garra, uña
griffe)      = hundir
griffer      = arañar
griffonner   = garrapatear
grille       = verja
grillé       = quemado
griller      = quemar
grimace      = mueca
grimpant     = enredadera
grincer      = gruñir
gris         = pardo, a
grisonnant   = canoso, a
grogner      = gruñir
groin        = hocico
grondement   = fragor
gronder      = gruñir, retumbar
gros         = gordo, a [adj], a, grueso
gros ennui   = apuro
gros lot     = gordo
gros mur     = paredón
grosse       = gordo, a
grosse tête  = sabihondo, a
grosse toile = jerga
grossier     = palurdo, bronco, a
grossir      = desorbitar, engrosar
grouiller    = hervir
groupe       = tanda
guenilles    = andrajo
guéridon     = velador
guet         = acecho
guetter      = acechar
gueule       = hocico
gueule de bois = resaca
guichet      = casilla, despacho
guitare      = jarana
gypse        = espejuelo

H
habile       = primoroso, a, habilidoso
habileté     = pericia, destreza
habilidosamente = habilidoso, a
habiller     = vestir
habitte      = paradero
habituer au feu = foguear
haché        = cortado, a
haie         = valla
haine        = odio
haïr         = odiar
haleine      = aliento
haler        = jalar
haletant     = jadeante
haleter      = jadear
hall         = antesala
halluciner   = alucinar
hanche       = cadera
handicap     = lastre
hangar       = nave
harassé      = molido
harcèlement  = acoso
harceler     = acosar, asediar, hostigar
haricot      = fabe, judía
harpie       = arpía
haste        = asta
hâte         = prisa
hausser      = alzar
haut         = altura, ápice
hautain      = altanero, a
haute mer    = piélago
hauteur      = altura
hazard       = azar
hébergement  = albergue
héberger     = albergar
hérissement  = erizamiento
hérisser     = erizar
hériter      = heredar
hésitant     = dudoso
hésiter      = dudar, vacilar
heure actuelle (à l') = altura (a estas)
heurt        = roce
heurter      = pegar (vi)
hiérarchie   = jerarquía
hiérarque    = jerarca
histoire     = pamema, cuento
hivernal     = invernizo
hochement    = cabeceo
homme        = roto, varón
homo         = raro (fam.)
honnête      = honrado, a
horreur      = espanto
horreur (figuratif) = buñuelo
horrible     = espantosa, horrendo, a
               ominoso
hors d'haleine = jadeante
hors saison  = extemporáneo, a
hors sujet   = extemporáneo, a
huées        = bronca
huer         = patear
huile        = óleo
humilier     = pisar, rebajar
hurlement    = alarido
hyperbolique = hiperbólico, a
hypothèse    = cábala

I
ici          = acá
idéal        = ideario, idóneo, a
idéaux       = ideario
idée saugrenue = ventolera
idéologie    = ideario
idiot        = patán, necio, a
ignorer      = eludir
illisible    = ilegible
illustre     = conspicuo, a
ilôt bas et sablonneux = cayo
image        = estampa
immaculé     = impoluto, a
immatriculation = patente
immense      = descomunal
immeuble     = finca
impair       = impar, torpeza
imperfecto subjuntivo creer = creyera
impétuosité  = impetu
impitoyable  = despiadado
impoli       = descortés
importance   = tamaño
important    = sustancioso
important (de poids) = gordo, a [adj]
imposteur (simulateur) = farsante
improbable   = dudoso
inaccessible = inalcanzable
inattention  = descuido
inaugurer    = inaugurar
incapaciter  = postrar
incident     = tropiezo
incisif      = afilado
inciter      = inducir
incliner     = reclinar, tumbar
incorporer   = incorporar
incroyant    = descreído, a
inculte      = baldío, a
incursion    = algarada, correria
indifférence = displicencia
indigestion  = hartazgo
indiqué      = idóneo, a
indispensable = imprescindible
indisposer   = esquinar
inducir      = indujeron
induire      = inducir
inégal       = escabroso
ineptie      = barbaridad
inépuisable  = inagotable
infesté      = plagado, a
informations = noticiario
informer correctement = desengañar
infortuné    = desventurado, a
ingénieur technique = perito
injurier     = increpar, maldecir
inoffensif   = inocuo
inonder      = anegar
inquiéter    = apurar
insalubre    = enfermizo, a
insidieux    = insidioso, a
insinuer     = deslizar, insinuar
insipide     = insulso, a
insister     = pugnar
insolence    = petulancia, desplante
insomnie     = desvelo
instable     = revuelto, a
installer    = acomodar
insulter     = despechar
intellectualité = intellectualidad
intellectuels = intellectualidad
intempérie   = intemperie
intensité dramatique = dramatismo
intention    = propósito, mente
intercéder   = mediar
intéressant(e) = sabroso, a
intérimaire  = transeúnte
interposer   = terciar
intervenir   = mediar, terciar
intimider    = achicar, toser
intrépide    = arrojado, a, atrevido
intriguer    = enredar
introduire   = colar
inventer     = discurrir
investigateur = indagador
investigation = indagación
invraisemblable = inverosímil
iota         = ápice
ir de lengua = ne pas tenir sa langue = lengua
irrachetable = irredimible
irréprochable = impoluto, a
irrité       = airado
isolé        = aislado
isoler       = aislar
itinéraire   = recorrido
ivresse      = embriaguez

J
jaillir      = brotar, surtir
jaloux       = moro, a
jambe        = pierna
janvier      = enero
jargon       = jerga
jarre        = pozuelo
jaspé        = jaspeado
java         = jarana
jean         = tejanos
jet          = chorreón, chorro, tiro
jetée        = espolón, malecón
jeter        = arrojar, botar, despedir
               echar, tirar
jeter à terre = aterrar
jeter un coup d'œil à = hojear
jeter un sort = hechizar
jeton        = chapa
joie         = jubilo
joint        = juntura
jointure     = juntura
joli         = lindo, a
joue         = mejilla
jouer        = desempeñar, jugar
               juguetear, triscar
jouer un tour = chasquear
joug         = yugo
jouir        = disfrutar
journal      = diario
journalier   = diario
journée      = jornada
jucher       = encaramar
judas (de porte) = mirilla
judicieux    = cuerdo
jugement     = juicio
jugeotte     = seso
jugué --> jugar = jugo (de)
juif(ive)    = judío, a
jumelage     = hermandad
jurer        = maldecir
jus          = jugo (de)
jus de cuisson = caldo

K
kermesse     = verbena
kiosque      = quiosco

L
la           = cuyo, a
là           = ahí
laborieux    = renuente
labourer     = labrar
lâche        = cobarde, flojo, a
lâche (nœud) = suelto, a
lacher       = soltarse
lacune       = laguna
lagune       = laguna
laid         = feo
laique)      = turiferario
laisse       = correa
laisser      = dejar
laisser-aller = desidia
lama         = llama
la Manche    = mancha
lambeau      = jirón
lame         = hierro, hoja
lamelle de talc = espejuelo
lampe        = lámpara
lampe de poche = linterna
lance        = asta
lancer       = arrancar, echar, tirar
lancer (bateau) = botar
lancinant    = punzante
langue       = lengua
languide (langoureux = lánguido
languissant) = lánguido
lanière      = tira
lapin        = conejo
laquer       = laquear
lard         = tocino
large        = ancho, a
largeur      = ancho
larguer      = plantar
latéral      = ladero, a
la tête basse = cabizbajo
latte        = lista
lavasse (café) = aguachirle
laver la tête = patear
leader       = cabecilla
leadership   = liderazgo
léchage      = chupada
lèche-bottes = pelota
lécher       = chupar, lamer
léger        = flojo, a, leve
légèreté     = levedad
le gros de   = grueso
légume       = hortaliza
lentement    = despacio
léopard      = pardo
les antipodes = quimbambas
léser        = desaforar
les hauts et les bas = baches
lésiner sur  = escatimar
lessive      = colada
lest         = lastre
lester       = lastrar
lettre       = letra
leure        = añagaza
lever        = alzar, erguir
lever du jour = amanecer
liaison      = asunto, nexo
libérer      = redimir, soltarse
libraire     = librero
licenciement = despedida
liderazgo    = liderato
liège        = corcho
lien         = nexo, vinculación, vínculo
lier         = vincular
ligne        = raya
lignée       = prosapia
limande      = gallo
lime         = lima
limer        = limar
limettier    = lima
limite       = dintel, linde, lindero
               raya
limpide      = diáfano
lin          = hilo
linge        = pañete
linger(ère)  = ropero, a
linteau      = dintel
liquéfier    = licuar
liquider     = deshacer, quemar, rematar
liseron      = enredadera
lisière      = orilla
lisser       = atusar
liste        = lista
lit          = cauce, lecho
livre de comptes = libreta
livrer       = entregar, librar
llamar a capítulo = demander des comptes = capítulo
loger        = albergar, alojar
loisir       = ocio
long         = extenso, a
longer       = bordear
longueur     = tiro
loquacité    = locuacidad
loques       = andrajo
lot          = lote
louange      = ditirambo
louche       = cazo, turbio
loucher      = bizquear
lourdeau     = palurdo
lourdeur     = pesadez, torpeza
loyauté      = lealtad
lueur        = atisbo, destello
lugubre      = tétrico, a
lui          = ése, a
lunettes     = espejuelos, gafa
lustre       = araña
lutte        = pugna
lutter       = contender, lidiar
luxe         = lujo
luxuriant    = frondoso, a
lymphe       = flema

M
machine      = aparato
ma cocotte   = flaco, gordo, a
maçonnerie   = mampostería
magasim (América) = bodega
magasin      = almacén
magasin d'objets religieux = santería
magicien     = mago, a
magnétophone = grabadora
magnitude d'un vecteur = impetu
maigre       = delgado, escaso, escuálido
               a, flaco
maigrir      = adelgazar, enflaquecer
main courante = pasamano
maitriser    = atajar
mal          = daño
maladif      = enfermizo, a
maladresse   = torpeza
malchanceux  = desafortunado, desdichado
               desventurado, a
maldijo --> maldecir = maldecir
mal du pays  = añoranza
mal foutu    = jodido (vulgar)
malgré       = pesar (a pesar de)
malheureux   = desafortunado, desdichado
               desventurado, a, ominoso
malignité    = malignidad
malin        = picaro, a, listo
malle        = baúl
malmener     = castigar
malsain      = enfermizo, a
mamelon      = pezón, tetilla
manche       = manga
manche (anse = mango
manchette    = puño
mandat       = despacho
manger       = roer
mangue       = mango
manguier     = mango
manier       = manejar
manière      = guisa
manières     = ademán, cursilería
manifeste    = patente, manifiesto, a
manœuvre     = peón, maniobra
manque       = ausencia
manque d'argent = apuro
manquer      = faltar
manquer de   = carecer de
manteau      = abrigo
marais       = pantano
marasquin (liqueur) = marrasquino
marbre       = mármol
marchand ambulant = buhonero, a
marche       = peldaño
marché aux puces = rastro
marcher      = andar, taconear
marcher sur  = atropellar, pisar
marmitte     = perol
marmot       = chiquillo, a
marmotter    = musitar
marraine     = madrina
marron (beigne) = trompada
massacre     = matanza
masse        = bulto, masa
masser       = amasar
massif       = macizo, a, multitudinario
matériel     = enseres
maton        = carcelero, a
matonne      = carcelero, a
maudire      = maldecir
Maure        = moro, a
mauvaises herbes = maleza
mauvais goût = cursilería
mauvais pas  = trance
mauvais payeur = tramposo
méandre      = vencueto
méchant      = malvado, a
médecine : accès = brote
médiocre     = flojo, a
méditation   = cavilación
meeting      = mitin
méfait       = bellaquería
méfiance     = recelo, suspicacia
mégot        = colilla
meistre (commandant d'un régiment sous l'ancien régime) = mosén
membre       = socio
même         = aun
même pas     = ni siquiera
même si      = siquiera
menace       = amago
menacer      = amenazar
ménager      = escatimar
ménagère     = cubertería
mendiant     = pordiosero, a
mener        = encauzar, manejar, vencer
mener à      = inducir
meneur       = cabecilla
meneuse      = cabecilla
mensonge     = embuste, mentira
menteur      = cuentista, mentiroso, a
menu         = menudo, a
mépriser     = despreciar
merde !      = joder !
mériter      = merecer
mérou        = mero
merveille (à) = pedir de boca (a)
message      = recado
messe        = misa
mestre       = mosén
mesure       = medida
métal blanc  = peltre
méticulosité = detallismo, escrúpulo
métis        = trigueño, a
mettre       = plantar, colocar, echar
               ingresar
mettre à la retraite = jubilar
mettre à son avantage = abrillantar
mettre bas   = alumbrar, parir
mettre dans le mille = acertar
mettre de côté = apartar
mettre en gage = empeñar
mettre en ordre = adecentar
mettre en travers = terciar
mettre face à face = enfrentar
mettre fin   = desvanecer
mettre ko    = noquear
mettre l'entête à = encabezar
mettre les pieds à = pisar
mettre les pieds dans le plat = cagar
mettre par terre = tumbar
mettre sens dessus dessous = revolver
mi           = mediado, mediados (a)
mi (à la)    = mediado, mediados (a)
micheline    = ferrobus
mie          = miga
mielleuse    = almibarada
miette       = migaja
miettes      = miga
militaire    = militar
militaire (adj.) = castrense
militer      = militar
mille marin  = milla (la)
minauderies  = pamema
mince        = delgado
mini         = escueto
minijupe     = minifalda
miracle      = milagro
miroir aux alouettes = espejuelo
mise         = apunte, puesta
mise au toril = encierro
mise en gage = empeño
mitrailleuse = ametralladora
mobile       = transeúnte
mobiliser    = reclutar
modérer      = entibiar
modeste      = escueto
moelle       = miga
moindre      = atisbo
moine        = fraile
moissonner   = cosechar
moitié       = pariente
moitié (à)   = mediado, mediados (a)
moitié (à la) = mediado, mediados (a)
môle         = espolón
mollet       = pantorrilla
moment       = rato
moment là (à ce) = sazon (a la sazón de)
moments difficiles = baches
momie        = momia
mon coco     = flaco, gordo, a
monnaie      = vuelta
monté en graine = espigado, a
montrer      = ostentar
moqueur      = burlón, zumbón, ona
morceau      = pedazo, bocado, retazo
               trozo
morceaux de viande = tropezon
morsure      = picadura
mortel       = letal
mortifier    = aspar, castigar
morve        = moco
mot de passe = contraseña
motivation   = aguijón
motiver      = enardecer
mou          = correoso, a
moucheter    = motear
mouchoir     = pañuelo
moudre       = moler
mouillage    = anclaje
mouiller     = fondear, mojar
mouler       = ceñir, vaciar
moulin à vent = ventolera
moulu        = molido
mourir d'envie de = reventar
mousse       = espuma
moyen (au .. de) = mediante
moyennant    = mediante
muer         = mudar
muet         = mudo, a
mulâtre      = pardo, a
mullir       = mullida
munir        = pertrechar
murer        = cegar
mûrir        = madurar
murmure      = susurro
murmurer     = susurrar
museau       = hocico
musique)     = carrozón
musulman     = moro, a
musulmane    = moro, a
muter        = trasladar
muy frondoso = frondosisimo
mystification = engaño
mythe        = mito

N
naissant     = incipiente
naitre       = brotar
nana         = tipo
nappe        = mantel
narguer      = refregar
narquois(e)  = socarrón, a
navire       = nave
navrant      = desolador, lastimoso, a
né           = nato, a
nécessiteux (-euse) = menesteroso, a
nef          = nave
négligé      = zarrapastroso, a
négligence   = descuido
ne pas être confortable = incomodidad
ne pas se rappeler = desmemoriarse
nerveux      = tenso
nervosité    = nerviosismo
net          = nitido
nettoyer     = adecentar, quitar
nettoyer (une arme) = foguear
nez          = proa
nez à nez    = frente
nichet (œuf en plâtre ou marbre) = nidal
nichoir      = nidal
nid de poule = bache
nier         = negar
niquer       = joder
niveau       = altura
noce         = juerga
nœud         = lazo
noir         = moro, a
nom          = nombre
nombreux     = cuantioso
nombrir      = ombligo
nomination   = nombramiento
nommer       = llamar
nonchalance  = displicencia
nonchalant   = displicente
non plus     = tampoco
non salissant = sufrido
nostalgie    = añoranza
no tener una perra = ne pas avoir un rond = perra
noter        = apuntar
nouer        = entablar
nourrir      = abrigar, albergar, criar
noyau        = carozo, hueso
noyer        = ahogar, anegar
nuage        = nube
nuancer      = teñir
nuée         = nube
nuire à      = dañar
nul          = desastroso
nylon        = nailon

O
obliger      = apremiar, conminar, obligar
               se
obscur       = oscuro, a
observer     = acatar, atisbar
obstacle     = lastre
obstiné      = empecinado, a
obstruer     = tabicar
obtenir      = alcanzar, conseguir
               cosechar
occuper      = ostentar
octroyer     = otorgar
offir        = deparar
offrir       = obsequiar, regalar
oignon       = cebolla
oiseux       = ocioso, a
oisif        = ocioso, a
onde         = onda
ondulation   = onda
ongle        = uña
opposer      = enfrentar
orangé       = anaranjado, a
orchestre    = tertulia
ordinaire    = corriente
ordonner     = mandar, ordenar
orgueilleux  = vanidoso
orienter     = encauzar
originaire   = oriundo
orner        = adornar
ornière      = bache
orphelin     = huerfano
orteguiano   = orsianos
os           = hueso
osé          = atrevido
oser         = atreverse
osier        = paja
ostensoir    = custodia
oter         = quitar
oublier      = desmemoriarse
oú qqn se trouve = paradero
ourdir       = urdir
outrageant   = ultrajante
ouvrier agricole = peón
ouvrir les yeux = desengañar
ouvroir      = ropero
oxyde        = óxido

P
page         = plana
paillasse    = jerga
paille       = paja
paillette    = escama
paire        = par
palais       = paladar
pale         = aspa
pâle         = desvaído
palier       = descanso, rellano
pâlir        = quebrar
pan          = tramo
panaméen(-ne) = panameño, a
panégyrique) = ditirambo
panique      = pavor
panneau      = tablón
panne de courant = apagón
panoplie     = parafernalia
papier       = papel
papillotage  = parpadeo
paquet       = bulto, cajetilla
par          = mediante
paradis      = paraíso
paralyser    = embargar
parapluie    = paraguas
paravent     = pantalla
parce que    = pues
parcourir    = andar, recorrer
parcours     = carrera, recorrido
pardessus    = gabán
par dessus le marché = postre (para)
pareil (adj.) = tamaño
parent       = pariente
parer        = componer, engalanar
paresse      = pereza
paresseux    = manta, vago
parfaitement = pedir de boca (a)
parfum       = esencia
parier       = apostar
parlant      = parlante
parler ou agir avec insolence ou effronterie = descararse
paroissien(-ne) = parroquiano, a
paroles      = letra
parsemer     = sembrar
part         = lote, medida
part (à ... ça) = demás (por lo ..)
partager     = compartir, comulgar
partie de chasse = cacería
partir       = arrancar, salir
parvenir     = lograr
pas          = pisada
pasible      = apacible
passage      = pasaje
passager     = pasajero, a
passagers    = pasaje
passant      = pasajero, a, transeúnte
passé        = desvaído
passe-droit  = prebenda
passer       = alargar, alcanzar, amainar
               asomar, pasar, pegar (vtr)
               colar, correr, discurrir
               sacar
passer du temps avec = convivir
passer un savon = patear
pâte         = masa
patente      = patente
pateux       = pastoso
patience     = aguanté
patient      = sufrido
patinage     = deslizamiento
patine       = pátina
patiner      = patinar
patron       = empresario, a
patte        = pierna
paturage     = pasto
pâturage     = prado
pature       = pasto
paupière     = párpado
pause        = descanso
pauvre       = desdichado, menesteroso, a
payer une partie de plaisir (se) = cana al aire (echar una)
paysan       = patán, payo, a
peau         = pellejo
peau de mouton = zamarra
peau de vache = hueso
peaufiner    = afinar, refinar
pêche        = pesquería
pêcherie     = pesquería
pédant       = redicho
pédant(e)    = sabihondo, a
pédé         = maricón, raro (fam.)
pédiculé     = ceñido, a
peigne       = peine
peine        = desazón, lástima, sinsabor
peiné        = pesaroso, a
peine (à)    = apenàs
peiner       = penar
peler        = pelar, despellejar
pelisse      = pelliza, zamarra
pelle        = pala
pellicules (cheveux) = caspa
pelouse      = prado
pénaliser    = castigar
pénalité     = castigo
penchant     = aficion
pencher      = tumbar
pendant      = pendiente
penderie     = ropero
pénis        = pene
pensée       = pensamiento
penser à     = acordarse
pente        = pendiente
pépinière    = vivero
perçant      = agudo, a
percer       = agujerear, espetar
percevoir    = vislumbrar
perche       = manga, tiento
perdant(e)   = perdedor, a
perdre       = adelgazar, extraviar
perdre connaissance = dervanecerse
perdre la mémoire = desmemoriarse
perdre ses illusions = desengañar
perdu        = perdido, a
permis)      = carnet
pérorer      = perorar
perquisition = registro
perron       = escalinata
personnage   = mito
personnel (employé) = plantilla
personne louche = prenda
personne vieux-jeu dans ses gouts (habillement = carrozón
personne vulgaire = plebeyo, a
perte        = perdido, a, perjuicio
               chorreo, quiebra
perturber    = reventar
pervertir    = estragar
pester       = maldecir
petit        = escueto, leve, menudo, a
petit (de mammifère) = cachorro
petit drap   = pañete
petite place = plazoleta
petitesse    = levedad
pétition     = petición
petit pois   = chicharo
petit poucet = cenicienta
petit puits  = pozuelo
pétrir       = amasar
peu enthousiaste = renuente
peuplier     = álamo
peur         = miedo, susto, temor
peureux      = desdichado
peut-être    = acaso, tal vez
photographier = retratar
phrygien     = frigio, a
pic          = pico
picoler      = chupar
pièce        = estancia
pied-de-biche = gafa
piège        = trampa
pierre       = losa
pierre de mauvaise qualité = lastre
pierreux     = pétreo
piétiner     = atropellar, patear
               pisotear
pieu (lit)   = sobre (el)
pieux        = piadoso, a
pieza ajustadora = pièce manquante = ajustador
pieza de hierro de la armadura en la que se apoya la lanza = ristre
pile         = pila, pozo
pin          = pino
pincer       = apretar
pingre       = roñoso, a
pion         = peón
pipe         = chupada
pique        = asta, vara
piqure       = escozor
piqûre       = picadura, punzada
pirate       = zamarra
pisser       = mear
piston       = muñeca
pitié        = lástima
pitoyable    = lastimoso, a
place        = butaca, hueco
place libre  = claro
placer       = acomodar, colocar, ubicar
placer en coin = esquinar
plaie        = daño
plaine       = plana, llanura
plaire       = agradar, prendar
plaisant     = placentero
plaisanterie = broma
plaisantin   = burlón
plaisir      = agrado, fruición
plan         = plano, designio
planche      = tablón
plan d'eau   = tablón
planque      = prebenda
plante       = planta
planté       = clavado
planter      = plantar, clavar
planter (ongle = hundir
plaque       = patente, chapa, losa
plaquer      = plantar
plat         = plano
plateau      = bandeja
plausible    = verosímil
plébéien     = plebeyo, a
plein        = repleto (de)
plein à craquer = abarrotado, a
plein (de)   = pletórico
plein de boue = embarrado
pleuvoir     = llover
pli          = arruga, raya
pli (document) = pliegue
plier        = plegar, quebrar
plomb        = plomo
plongeoir    = tablón
plonger      = hundir, zambullir
plongeur     = buzo
plouc        = patán
pluie fine   = rocio
plumer       = pelar
poche        = bolsa, bolsillo
poder        = pudiendo
poêle        = sartén
poêlée       = sartén
poignée      = pañado, puñado, puño
poignée)     = mango
poignet      = puño, muñeca
poil du pubis = pendejo
poinçon      = cuño
poindre      = apuntar
poing        = puño
pointe       = pico
pointer      = apuntar
point nommé (à) = perilla
pointu       = agudo, a, punzante
poire (se faire avoir) = primo, a
polir        = pulimentar, limar, refinar
pommette     = pómulo
pomper       = tragar
pompon       = borla
pomponner    = arreglar, engalanar
poncer       = raer
ponche       = daiquirí
pondoir      = nidal
ponte        = puesta
populaire    = sonado, a
porc         = cerdo
porc de boucherie = matanza
portable     = portátil
portatif     = portátil
porte-documents = cartera
portée       = alcance, tiro
portefeuille = cartera
portemanteau = gancho
porter       = portar, se, llevar, vestir
porte vitrée = cristalera
portion      = cazo, tapa, trecho
pose         = pose
poseer       = poseían
poser        = afinar, pegar (vtr)
               plantar
poseur       = redicho
posséder     = poseer
possessif    = moro, a
poster       = apostar
pot-de-vin   = soborno
pote         = socio
poteau d'exécution = paredón
poudre       = pólvora
poupée       = muñeca
pour couronner le tout = postre (para)
pourri       = podrido, a
poursuite    = acoso
poursuivre   = perseguir, prosequir
pourvu       = provisto, a
pousse       = brote
poussée      = empuje
pousser      = pegar (vtr), brotar
               empujar
pousser à bout = desbordar
poussière    = polvo
poussiéreux  = polvoriento
pouvoir      = poder
prairie      = pradera
pratique     = incomodidad
pratiquer    = profesar
pré          = prado
prébende     = prebenda
précaire     = prestado
précieux     = valioso
précipice    = barranco
précis       = concreto
prédiction   = cábala
prééminent   = relieve
préemption   = tanteo
préféré      = predilecto
préjudice    = perjuicio
préjugé      = prejuicio
prémédité    = alevoso, a
première place = liderazgo
prendre      = agárrar, pegar (vi)
               prender, coger, colar
               quitar, sacar, tomar
prendre d'assaut = asaltar
prendre (du temps) = costar
prendre la main = desbocarse
prendre un en-cas = almorzar
prendre un raccourci = atajar
prénom       = nombre
préparer     = arreglar, pertrechar
               guisar
près         = cerca
présenter    = deparar
présomptueux = vanidoso
presse       = prensa
pressentir   = barruntar, intuir
               vislumbrar
presser      = apremiar, apretar, prensar
               conminar
présumé(e)   = presunto, a
présumer     = suponer
prêt         = listo, a
prêté        = prestado
prétentieux  = soberbio, a
prétention   = ínfulas
preuve       = prueba
prévenir     = advertir, avisar
prévoir      = barruntar
prier        = rogar
prime        = prima
primitif     = primigenio
privilège    = prebenda
prix (récompense) = galardón
proche       = allegado, cerca
proche parent = pariente
proclamer    = pregonar
procurer     = deparar
produire     = criado, a
professer    = profesar
profit       = provecho
profiter     = disfrutar
profits      = ganancias
profond      = entrañable
profond(e)   = hondo, a
profus       = profuso
proie        = presa
projet       = proyecto, designio
projeter     = proyectar, impostar
prolonger    = alargar, dilatar
promotion    = ascenso
prononcer ses vœux = profesar
prononcer un discours = perorar
prophète     = agorero, a, profeta
propos (à)   = propósito
proprement   = limpiamente
propriétaire = dueño
propriété    = finca
propriété foncière = predio
prosopopée   = prosopopeya
prospérité   = bonanza
protecteur   = valedor, a
protégé      = ahijado, a
proue        = proa
prouesse     = proeza
prouver      = argüir, probar
provoquer    = despertar, encender
prude        = gazmoño
prudence     = tiento
prudent      = cauto
puant        = apestoso, a
puanteur     = hedor
puce         = pulga
puissance    = potencia, potestad
puissant(e)  = poderoso, a
puits        = pozo
punir        = penar, castigar
punition     = castigo
purger       = cumplir
putain !     = joder !
putride      = podrido, a
putschiste   = golpista
puzzle       = rompecabezas

Q
qqu'un       = descojonarse
quai         = muelle
quartier     = cuartel
quartier général = cuartel
quelques     = pañado, puñado
quequette    = pito
querer       = quiso
queue        = cola
queue (botanique) = pezón
queue-de-pie = casaca
qui a le don d'ubiquité = ubicuo
qui a mauvaise mémoire = desmemoriado
quiconque    = quienquiera
qui fait de la peine = lastimoso, a
quignon (de pain) = chusco
quignon de pain = migaja
qui ne peut pas être reporté -> aplazar = inaplazable
quitar       = quiten
quittance    = recibo
quitter      = dejar
qui veille   = velador
quote-part   = cuota
quotidien    = diario

R
rabaisser    = pisar, rebajar
rabatteur    = gancho
rabattre     = descontar
raboteux     = áspero, a
raccourci    = atajo
racheter     = redimir
racine       = raíz
racines      = raigambre
racler       = raer, rascar
radin        = chucho, roñoso, a
rafale       = ventolera
rafale (de vent) = racha
raffinage    = refino
raffiné      = exquisito, refino
raffiner     = refinar
ragout       = cazuela
ragoût de pain frit avec des lardon = migas
raid         = correria
raide        = empinado
raie         = raya
raie manta   = manta
railleur     = burlón
raison       = fundamento
raisonnable  = cuerdo
rallonger    = alargar, sacar
ramasseur de balles = pelotero
ramassis     = atajo
rance        = rancio
ranch        = estancia, rancho
rancœur      = inquina
rang         = fila
rangée       = hilera
ranger       = ordenar, recoger
rapine       = rapiña
rapport      = ponencia, nexo, relato
               reporte
rapporter    = referir, traer
raquette     = pala
raquette (nopal = penca
rare         = escaso, raro
raser        = afeitar, rapar
raseur       = latoso
rassembler   = aglutinar
rat          = chucho
rattacher    = adscribir
rattraper    = alcanzar
rauque       = bronco, a, ronco
ravage       = estrago
ravager      = arrasar, asolar, estragar
ravin        = barranco
ravissant    = primoroso, a
ravitailler  = abastecer
rayer        = pautar, borrar
rayon        = estante
rayonnage    = estanteria
rayure       = lista, raya
razzia       = algarada, razia
rebondir     = botar, saltar
rebuter      = desalentar
réception (action) = recibo
recevoir     = acoger
recevoir chaleureusement = agasajar
recherche    = pesquisa
rechercher   = averiguar, perseguir
rechignant (en) = regañadientes (a)
récit        = relato
réclame      = reclamo
réclusion    = encierro
recoin       = rincón
récolter     = cosechar, recabar
recommander  = aconsejar
récompenser  = premiar
réconfort    = consuelo
reconnaissant = agradecido
recourir à   = acogerse
récriminer   = recriminar
recrutement  = reclutamiento
recruter     = reclutar
reçu         = descargo, recibo
recul        = retroceso
reculer      = arredrarse, retrasar
               retroceder
récupérer    = aprovechar, rebañar
               recabar
redit        = redicho
redoubler    = apretar
redresser    = erguir, incorporar
réduire      = escatimar, recortar
réduire en miettes = trizar
referir      = refiere
réfléchir    = discurrir
reflet       = espejuelo
réflexion    = cavilación
reflux       = reflujo
réfréner     = frenar
refuge       = albergue, cobijo
refuser      = plantarse, negar
regard       = vista
régenter     = regentar
région       = comarca
registre     = registro
réglage      = ajuste
régler       = arreglar, pautar, despachar
regret       = añoranza
regretter    = lamentar, se
regrouper    = aglutinar
rein         = riñon
rejet        = vástago
rejeter      = despreciar, rechazar
rejeton      = vástago
rejoindre    = agregarse
relâché      = suelto, a
relacher     = soltarse
relatif à Pío Baroja (romancier) ou son œuvre = barojiano, a
relatif aux allumettes = fosforero, a
relever      = alzar, arremangar
relief       = relieve
relier       = encuadernar
relieur(se)  = encuadernador, a
remarquable  = conspicuo, a
remarquer    = advertir
rembourser   = devolver
remercier    = agradecer
remettre     = devolver, encajar, entregar
               remitir
remorquer    = arrastrar
rempli       = plagado, a
remplir      = abarrotar, desempeñar
               llenar, rellenar
remuer       = revolver
rendez-vous  = cita
rendre       = devolver
rendre cruel = encarnizar
rendre dense = tupir
rendre fou   = desquiciar
rendre furieux = enfurecer, ensañar
rendre heureux = complacer
rendre inaliénable = vincular
rendre malade = enfermar
rendre massif = macizar
rendre public = pregonar
rendre (vomir) = arrojar
renforcer    = afianzar
rengainer    = enfundar
renom        = nombre
renoncer     = cejar
rentrer      = ingresar
renverser    = aterrar, atropellar
               derramar, derribar, tirar
               tumbar, verter, volcar
renvoi       = cese, despedida
renvoyer     = despedir, devolver
renvoyer à   = remitir
repaire      = escondrijo
répandre     = derramar, difundir, regar
               rociar
réparer      = componer
répartir     = impartir
répertoire des rues = callejero
répéter      = menudear
répétition   = ensayo
replat       = rellano
replier      = replegar
reporter     = aplazar
repos        = descanso
repousser    = rechazar, retrasar
répugnant    = ominoso
réputation   = fama
requin       = tiburón
résident temporaire = transeúnte
résistance   = aguanté, fortaleza
résister     = aguantar
résister à   = contrastar
résonner     = retumbar, tronar
résoudre     = dirimir, sacar
respecter    = acatar, cumplir
resplendissant = refulgente
ressac       = resaca
resserrer    = asegurar, templar
ressort (horloge) = cuerda
ressortir    = destacar, resaltar
restant      = sobrante
reste (le)   = demás
rester lettre morte = encallarse
rester (quedar) = faltar
retardé      = atrasado
retard (en)  = atrasado
retarder     = demorar, se, retrasar
retarder de  = retrasar
retenir      = aguantar, contener
retentir     = retumbar
retentissant = sonado, a
retenue d'eau = pantano
réticent     = reacio, renuente
retirer      = arrancar
retour       = vuelta
retourner    = volver
rétracter    = retraer
retraité     = jubilado
rétrécir     = achicar, encoger
rétrécissement = encogimiento
rétribuer    = retribuir
retrousser   = arremangar
réunion entre amis = tertulia
réunir       = recabar
réussir      = acertar, lograr
réussite     = éxito
revêche      = áspero, a
réveil       = despertar (un)
réveiller    = despertar
revendiquer  = recabar, vindicar
revenir      = acudir, volver
rêver        = alucinar
réverbère    = farol
réverbère)   = candelabro
revers       = sinsabores, vuelta
réviser      = revisar
révocation   = cese
révolte      = rebeldía
revue)       = portada
rhum         = ron
riche        = sustancioso
ride         = arruga
rideau       = cortina
rider        = arrugar
rien  à foutre = carajo (me importa un carajo)
ripaille     = cuchipanda
rire         = reir
rivage       = ribera
rivaliser    = contender
rive         = ribera
rixe         = refriega, riña
riz          = arroz
robe de chambre = bata
robuste      = pujante, fornido, a, recio
roc          = roble
rocailleux   = pedregoso
rôder        = merodear
rôle         = papel
romain       = romano, a
romanesque   = novelesco, a
ronchonner   = gruñir
rond         = redondo
rond(e)      = curdo, a
ronde        = corro, rueda
rondelle     = rodaja
rond-point   = glorieta
ronfler      = roncar, zumbar
rongé        = carcomido, a
ronger       = carcomer, roer
rongé -> roer = roido
rosée        = rocio
rosier       = rosal
roue         = rueda
roué de coups = molido
rougeátre    = rojizo
rougeur      = llamarada
rouille      = óxido
rouillé      = roñoso, a
rouleau      = rodillo
rouler       = atrapar, rodar
roulettes (comme sur des) = pedir de boca (a)
route        = rumbo
route (Nautique) = derrota
routine      = rutina
rozar        = roce
rudesse      = aspereza
rugosité     = aspereza
rugueux      = áspero, a
ruine        = ruina
ruiner       = desollar
ruineux      = ruinoso, a
ruisseau     = arroyo, riachuelo
ruissellement = chorreo
rupture      = quiebra
rusé         = astuto, a
rustre       = bronco, a, zamarra

S
s'abattre sur = azotar
saber        = sabrían
s'abimer     = echarse a perder
sabot        = uña, zueco
saboter      = reventar
sac          = bolsa, saco
sac à dos    = mochila
sachet       = sobre (el)
sacrer       = consagrar
safran       = azafrán
sagesse      = sabiduria
sagouin      = cochino, a
saigner      = estrujar
saillie      = desplome
sainte nitouche = gazmoño (familier)
sainteté     = santería
saisir       = agárrar, embargar
salaud       = cerdo
sale         = feo
salir        = salga
salle de classe = aula
salle de cours = aula
salpêtre     = salitre
s'amuser     = disfrutar
sangsue      = sanguijuela
sans-cœur    = desalmada
sans consistance = suelto, a
sans esprit  = desventurado, a
sans faute   = fijo, a
sans-gène    = desaprensivo, a
sans paire   = impar
sans voix    = atónito, a
s'apaiser    = remitir
s'approvisionner = repostar
s'arrêter    = detenerse
s'assurer    = cerciorarse
satisfaire   = saciar
s'attarder   = demorar, se
saucer       = rebañar
saucisse catalane (Languedoc : boutifarre) = butifarra
sauf (préposition) = salvedad
sauf(sauve)  = salvo, a
saugrenu (péjoratif) = estrafalario
sauter       = botar, brincar, saltar
sauts rapides = tocino
sauvage      = agreste
sauvegarder  = salvar
sauver       = salvar
savane       = sabana
savoir       = poder, saber, sabiduria
savoir-faire = pericia
savon        = jabón
s'avouer vaincu = arredrarse
savoureux(se) = sabroso, a
scabreux     = escabroso
scène        = escena
scénographie = escenografia
schéma       = esquema
scintillement = destello
scintiller   = parpadear
scribe       = escriba (un)
scrotum      = escroto
scrupule     = escrúpulo
scrupulums   = escrúpulo
se battre    = pelear, pugnar
se briser    = reventar
se buter     = empecinarse
sec          = sediento, a
se calmer    = aflojar, amainar, desfogar
s'écarter de = apartarse
se changer les idées = despejarse
s'échapper   = librarse
s'échauffer  = calentar
sécher       = secar
sécheresse   = sequedad
se comporter = portar, se
se confesser = confesarse
se coucher   = acostar(se), plantarse
se coucher tard = desvelar
secouer      = sacudir, se, traquetear
s'écouler    = discurrir
secrétaire (meuble) = escritorio
se creuser la tête = estrujarse
se crevasser = cuartearse
s'écrouler   = desmoronarse
se débarrasser = sacudir, se
se débarrasser de = librarse
se débattre  = forcejear
se décourager = desmoronarse
se dégager   = despejarse
se dégonfler = acobardarse
se démener   = forcejear
se déplacer  = deslizarse
se dépouiller de = despojarse
se dérober   = acobardarse
se dérouler  = discurrir
se déverser dans = desbocar
se disputer  = pelear, enzarzarse
se dissiper  = dervanecerse
se distinguer = destacar, resaltar
séduire      = castigar
se faire beau = engalanar
se faire conseiller par = aconsejarse
se faufiler  = deslizarse
se fendre    = cuartearse
s'effondrer  = derrumbar, desmoronarse
               desplomarse
se foutre de qque chose = descojonarse
se foutre en rogne = encabronarse
se heurter à = tropezar
se jeter     = tirarse
se jeter (à  = verter
se jeter dans = desbocar
séjour       = estancia
se lamenter  = lamentar, se
s'élever à   = sumar
se lézarder  = cuartearse
s'éloigner de = apartarse
selon        = según
se marrer    = descojonarse
s'emballer   = desbocarse
semé         = sembrado, a
semelle      = plantilla
semence      = semilla
semer        = burlar, rociar, sembrar
se mettre d'accord sur = acordar
se mettre en colére = encabronarse
semis        = sembrado, a
sémite       = semita
s'emmêler dans des ronces = enzarzarse
se moquer    = burlar
s'emparer de = apoderarse
s'empiffrer (de) = atiborrarse
s'emporter   = arrebatarse
s'endetter   = empeñar
s'ennuyer    = aburrir, se
s'en prendre à = atacar, toser
sens         = sentido
sens dessus dessous = revuelto, a
s'en sortir  = salvarse
sentier      = sendero
sentir       = sentir
s'envoler    = desorbitar, esfumarse
séparer      = apartar, arredrar
se passer (de) = prescindir
se pencher à = asomarse
se poiler    = descojonarse
se pousser   = apartarse
se présenter = acudir
se priver de = despojarse
se produire  = suceder
se propager  = correr
se prosterner = postrarse
séquestré    = chupado, a
se rappeler  = acordarse
se rassasier = saciar
se réjouir   = gozar
se rendre    = arredrarse, entregar
se rendre compte = advertir
se replier   = retraer
se ressembler = asemejar
se retourner = volcar
se retrancher derrière = acogerse
série        = tanda
serrer       = apretar, estrechar
               estrujar
serrer dans ses bras = abrazar
serrure      = cerradura
serrure (américa) = chapa
serviette    = paño, cartera, toalla
servir       = despachar, militar
serviteur dévoué = cortesano, a
se salir     = manchar
se servir de = aprovechar
se souvenir de = acordarse
s'étendre    = tirarse
s'étirer     = desperezarse
seuil        = dintel, umbral
seul         = mero, a
s'évanouir   = dervanecerse
s'évaporer   = esfumarse, volar
se volatiliser = esfumarse
sevrer       = despechar
siffler      = patear, pitar, silbar
sifflet      = pito, silbato
signalement  = reseña
signaler     = apuntar
signe        = seña
signe avant-coureur = amago
silhouette   = bulto, figura
sillet       = ceja
s'imbiber    = chupar
similaire    = afin(es)
simple       = escueto, sencillo
s'imposer    = sobreponerse
sincère      = sentido
sinécure     = prebenda
sinécure (América) = hueso
s'inscrire   = apuntarse
s'introduire = deslizarse
sirop        = almíbar
sisymbre (Bot.) = jaramago
situation difficile = aprieto
situer       = ubicar
slip         = calzon, calzoncillos
snobisme     = cursilería
sobras = restes (repas) = sobra
sobrevenir   = sobrevino
socle        = peana
soif         = afán
soin         = cariño, esmero
soirée       = velada
soirée dansante = baile
solennel     = enfático
solide       = pujante, recio
sombre       = pardo, a, oscuro
sombrer      = zozobrar
sommeil profond = modorra
sommer       = conminar
sommet       = ápice
sonder       = tantear
sonnant      = clavado
sonner       = llamar
sonore       = sonoro
s'opposer à  = tropezar
sort         = hechizo
sorte        = suerte
sortilège    = hechizo
sortir       = asomar, brotar, espetar
               sacar, salir
sortir de    = desbordar
sortir de son orbite = desorbitar
sot          = necio, a
sou          = cobre
souche       = raigambre
soudain(e)   = repentino, a
soudoyer     = sobornar
souffler     = apuntar, pisar, soplar
souffleur    = apunte
souffrance   = daño
souffrir     = aguantar, sufrir
souffrir de  = padecer
soulagement  = consuelo, descanso
soulard(e)   = curdo, a
soulevé      = revuelto, a
soulèvement  = sublevación
soulever     = alzar
soulever le cœur = revolver
souligner    = apuntar, destacar
soupçon      = atisbo, recelo
sourcil      = ceja
sourd        = pardo, a
sournois(e)  = socarrón, a
sournoiserie = socarronería
sous-sol     = sótano
soute        = bodega
soutenir     = sostener
soutien      = soporte, sostén
soutien-gorge = sostén
souvent      = menudo (a menudo)
souverainement = soberanamente
spin         = espin
spirituel    = agudo, a
sport        = deportivo, a
sportif      = deportivo, a
sportif étranger dont le père ou la mère ne le sont pas = oriundo
squame (peau) = escama
stratège     = estratega
stressé      = tenso
stresser     = tensar
stupéfaction = asombro
stupéfait    = atónito, a
stupéfiant   = asombroso
stupéfier    = asombrar
stylo-bille  = boligrafo
substance    = miga
substantiel  = sustancioso
substantiel(le) = sabroso, a
suc          = jugo (de)
succéder à   = suceder
succès       = éxito
succint      = escueto
suceder      = sucedido
suelto (monnaie) = suelto
suer         = sudar
suffire      = bastar
suffisant    = engreído, a
suggérer     = sugerir
suggestion   = sugerencia
suinter      = sudar
suite        = séquito
suite de (à la) = raíz de (a)
sujet        = asunto, propenso, a
superbe      = desdén, soberbio, a
superposer   = sobreponer
support      = soporte
supporter    = aguantar, padecer, poder
               sufrir
supporters   = aficion
supposer     = suponer
supposition  = cábala
suprême      = sumo, a
surabondance = acopio
surgeon      = vástago
sur la pointe des pieds = empinado
surmonter    = salvar, sobreponerse
               sortear, vencer
surnom       = apodo
survenir     = sobrevenir
susceptible  = sentido
suspendu     = pendiente
suspicion    = recelo, suspicacia
susurrer     = susurrar

T
tableau      = pizarra
tache        = chorreón, mancha
tâche        = quehacer, tanda
tache (figuré) = lámpara
tacher       = manchar
tacheter     = motear
taffe        = chupada
taie (dans l'œil) = nube
taille       = cintura, tamaño
taillé       = afilado
tailler      = podar
talent       = gracia
talon        = tapa
tangage      = cabeceo
tanière      = madriguera
tannage      = curtido
tanné        = curtido, a
taper        = pegar (vi), teclear
taper des pieds = patear, triscar
taper (se)   = zumbarse a alguien
tapis        = alfombra
taquin       = burlón
taré         = desquiciado
tartiner     = untar
tas          = pozo, montón
tasse        = taza
tasser       = apretar
tâter        = tantear, tentar
tâtonnement  = tanteo
tâtonner     = tantear
taureau      = toro
taxé de      = tildado
tchèque      = checoslovaco
teindre      = teñir
teinter      = teñir
temer        = temido
témoin       = testigo
témoin (mariage) = madrina
tempe        = sien
temps libre  = ocio
tenailler    = atenazar
tendre       = estirar, tensar, tierno, a
tendresse    = cariño, ternura
tendreté     = ternura
tendu        = tendido, tenso
tener higado = avoir du cran = hígado
tener malas pulgas = avoir mauvais caractère = pulga
tenir        = aguantar, poder, cuajar
               cumplir, regentar, sostener
teñir        = tiñe
tenir tête   = plantarse
tentant      = apetecible
tentative téméraire = intentona
tenter       = tentar
ténu         = tenue
terme        = paradero
terminer épuiser = acabar
terrain      = terreno, a
terrain découvert = explanada
terrasse     = azotea
terrestre    = terreno, a
terrible     = espantosa, tremendo, a
terriblement = tremendamente
terrier      = madriguera
terrifier    = aterrar
test         = ensayo
tester       = tentar
tête         = testa
tête (figuratif) = cerebro
tétine       = tetilla
têtu         = empecinado, a, terco
               testarudo, tozudo
texan        = tejano, a
thé          = tertulia
thuriféraire (ministre servant = turiferario
tienta (tauromachie) = tienta
tige         = vara, vástago
timbale      = timbal
timbré       = sonado, a
timide       = cortado, a
timidité     = encogimiento
tintement    = tintineo
tinter       = tintinear
tintinnabuler = tintinear
tir          = disparo, tiro
tirage       = tiro
tirelire     = calcetin
tirer        = jalar, sacar, tirar
               tirarse
tirer au but (sport) = rematar
tirer au sort = sortear
tirer sur    = pitar
tiret        = raya
tiroir       = cajon, gaveta
tissage      = tejida
tisser       = tejer
tissu        = paño, tejida, tela
titiller     = aguijonear
titre de grand maître (militar) = maestrazgo
titres       = entradilla
tituber      = vacilar
toile        = tela
toile cirée  = hule
toile de coton = manta
toile de mauvaise qualité = pañete
tolet (nautic.) = tolete
tombe        = hoya, hoyo
tomber       = aflojar
tomber de haut = desengañar
tomber sur   = topar, tropezarse
tome (livre) = tomo
tondre       = atusar, pelar, trasquilar
tondu        = trasquilado
tonnelle     = glorieta
tonner       = retumbar, tronar
tonnerre     = trueno
ton sarcastique = sorna
tonsure      = trasquilado
toquer       = llamar
torchon      = paño
tordre une dent = triscar
torride      = tórrido
tort         = perjuicio
torturer     = atormentar
toser        = tose
total        = masa
total(e)     = rotundo, a
totalement   = rematadamente
totalité     = masa
tôt (plus)   = atrás
toucher      = pegar (vi), cobrar, lindar
               rozar
touffe       = mata
touffu       = frondoso, a, tupido
toupet       = bisoñé
tour         = derredor, tanda, torreón
               vuelta
tourbillon   = torbellino
tour de guet = atalaya
tourmenter   = aspar
tournant     = vuelta
tourné (lait) = cortado, a
tourner      = volver
tourner mal  = echarse a perder
tournoi      = torneo
tousser      = toser
tout de suite = ahorita, ahoritita
tout juste   = apenàs
tout-puissant = prepotente
tracas       = pesadumbre, sinsabor
trace        = pisada, rastro
tracer des portées sur (mus.) = pautar
tradition    = raigambre
traditionnel = consabido
traduire     = verter
trafiquer    = enredar
trahir       = delatar, traicionar
traîne       = cola
traîne (à la) = atrasado
trainer      = arrastrar, rodar
trait        = rasgo, tiro
traite       = letra
traiter      = despachar
traiter de tous les noms = maldecir
traitre      = alevoso, a, traicionero
traitresse   = alevoso, a
traitrise    = alevosía
trajet       = trecho
tranche      = rodaja, tajada
tranchée     = foso
trancher     = contrastar, dirimir
               rebanar
transe       = trance
transférer   = trasladar
transformer  = trocar
translucide  = diáfano
transmettre  = remitir
transpercer  = pasar, traspasar
transporter  = llevar, trasladar
transporter de joie = alborozar
transvasement = trasiego
trappe       = trampa
traquer      = acosar
travail      = quehacer
travailler   = labrar
traverser    = pasar, espetar, traspasar
trébuchement = tropezon
tremblant    = temblón
trembler     = temblar
trempar de sueur = sudar
tremper      = empapar, mojar, templar
trépigner    = patear, triscar
très français = afrancesado
très mal     = pesimamente
très mauvais = pésimo, a
tresser      = tejer
tricheur     = tramposo
tricoter     = tejer
triomphe     = lauro
triplure     = entretela
tripot       = garito
tripoter     = traquetear
trique       = tolete
trocart      = trocar
trognon      = troncho
tromper      = burlar, chasquear, engañar
tromperie    = engaño
trompeur     = engañoso, a
tronc        = tronco
tronçon      = tramo, trecho
trope (emploi d'un mot dans un sens figuré = tropo
trop liquide = aguado, a
trop vaste   = inabarcable
troquer      = trocar
trotteur (pour marcher) = andadera
trottoir     = acera, orilla
trou         = agujero, bache, hoya, hoyo
trouble      = desasosiego, turbio
troublé      = revuelto, a
trouillard   = pendejo, desdichado
troupe       = campamento
trousse      = estuche
trouvaille   = hallazgo
trouver      = acertar, hallar
trouver (se) = obrar
truand       = truhán
truelle      = plana
tube         = éxito
tuerie       = matanza
tuile        = teja
turgescence  = turgencia
turlupe      = chupada
tuyau        = manga
type         = tipo
typographe   = ajustador
Tyr          = Tiro

U
ubiquiste    = ubicuo
ultime       = postrer
une          = plana
une (journal = portada
unité (à l') = suelto, a
un sage      = cuerdo
urine        = orina
urinoir      = mingitorio
usé          = gastado, a, raido
user         = gastar, raer
usine        = planta

V
vacances     = descanso
vague        = desvaído, racha, vago
vain         = baldío, a
vaincre      = derrotar, vencer
vaisseau     = nave
vaisselle    = losa, loza, vajilla
valle        = vallita
vallée       = hoya, valle
vanité       = ínfulas, vanidad
vaniteux     = vanidoso
vantard      = vanidoso
va-nu-pieds  = desharrapado
vapeur       = vaho
varlope (grand rabot) = garlopa
vaste        = dilatado, a
vautour (~requin) = buitre
veille       = vela, víspera
veille de (à la) = víspera (en .. de)
veillée      = verbena
veiller      = velar
veilleur     = velador
vélaire      = velar
velar        = velada
vendeur(-se) (de vêtements) = ropero, a
vendre       = despachar
vendre au rabais = quemar
venger       = vindicar
venir        = acudir, asaltar
venir de     = oriundo
vente        = despacho
ventre       = barriga
vent (violent) = vendaval
vêpres       = víspera
verbiage     = verborrea
verbosité    = verborrea, verbosidad
vergeture    = estría
vérification = comprobación
vérifier     = comprobar
vermoulu     = carcomido, a
vernir       = barnizar
verre        = trago, vidrio
verres de lunettes = espejuelos
verrière     = cristalera
versant      = ladera
verser       = ingresar, verter
verve        = empuje
verveine     = verbena
vésanie      = vesania
veste        = chaqueta
vestimentaire = indumentaría
vestir       = vista
vêtement     = prenda
veuf         = viudo, a
veuve        = viudo, a
viajar       = viajado
vide         = claro, vacio
vider        = vaciar
viellot      = vejete
vieux (vieille) = vejete
vif          = agudo, a
vigueur      = fortaleza
villageois   = payo, a
ville des Canaries = Caleta
vin          = caldo
vindicatif   = vengativo, a
virago (femme d'allure masculine = marimacho
virer        = botar
virilité     = hombría
visage       = rostro
vitre        = ventanilla
vitreux      = vidrioso
vitrine      = escaparate
vivacité     = empuje
vivier       = vivero
vivres       = viveres
voile        = vela
voilée       = velada
voiler       = velar
voisin(s)    = afin(es)
voiture      = carro
voiture-couchette = alcoba
voiture-lit  = alcoba
vol à l'arraché = tirón
voler        = quitar, volar
volonté      = designio
vomitif      = vomitivo, a
vouloir      = querer
voyager      = peregrinar, viajar
voyage rapide = correria
voyageur (-euse) = peregrino, a
voyante      = pitonisa
vraisemblable = verosímil
vue          = vista

Y
yacht        = yate
yeux         = vista

Z
zizi         = pito

