A
abanicar     = éventer
abarrotado,a = plein à craquer, bondé
abarrotar    = remplir
abarrote     = ballot / épicerie (amérique)
abastecer    = approvisionner, ravitailler
abigar = ?
abofetear    = gifler
abrazador    = brulant, accablant
abrazar      = serrer dans ses bras,
               épouser, entrer dans
abrehuecos   = ?
abrigar      = couvrir / nourrir
abrigo       = manteau, abri
abrillantar  = faire briller, mettre à son avantage
abrumador    = accablant, épuisant
aburrir/se   = ennuyer, s'ennuyer
acá          = ici
acabar       = finir, achever, terminer épuiser
acaecer      = avoir lieu, arriver
acaloradamente = ?
acalorar     = donner chaud / échauffer
acariciar    = caresser
acaso        = peut-être
acatar       = observer, respecter
acechar      = guetter
acecho       = guet, affût
acera        = trottoir
acero        = acier
acertar      = atteindre, mettre dans le mille,
               deviner, trouver, bien choisir
acertar      = bien faire, réussir
achicar      = rétrécir, écoper, drainer, intimider
acobardar    = faire peur à, décourager
acobardarse  = se dérober, se dégonfler
acoger       = recevoir, accueillir
acogerse     = se retrancher derrière, recourir à
acomodar     = faire asseoir, installer, placer,
               ajuster, aménager
acomodaticio,a = accomodant
aconsejar    = conseiller, recommander
aconsejarse  = demander conseil à,
               se faire conseiller par
acontecimiento = évènement, fait
acopio       = surabondance
acordar      = décider, convenir de,
               se mettre d'accord sur
acordarse    = se souvenir de, se rappeler,
               penser à
acosar       = traquer, harceler
acoso        = poursuite, harcèlement
acostar(se)  = coucher / se coucher
acrata       = anarchiste
actitud      = attitude, comportement, conduite
activo       = actif
acudir       = faire appel à, avoir recours à
acudir       = venir, revenir, se présenter
acuñar       = frapper / bercer
adecentar    = nettoyer, mettre en ordre
adelantar    = avancer, dépasser, doubler
adelgazar    = maigrir / perdre
ademán       = geste / manières, façons
adiestrar    = dresser, entraîner, exercer
adiposo      = adipeux
adherir      = coller, fixer
adornar      = décorer, orner
adscribir    = attribuer, fixer, rattacher
aducir       = alléguer
adujo  -> aducir (3e pers. sing. pret. ind.)
advertencia  = avertissement
advertir     = avertir, prévenir
advertir     = remarquer, constater,
               se rendre compte
afán         = ardeur, soif, désir véhément,
               efforts
afeitar      = raser
aferrar      = accrocher ?
afianzar     = consolider, renforcer
aficion      = penchant, goût, amateur de
               supporters, fans, amateurs
afilado      = effilé, aiguisé, taillé, incisif
afilado      = affûtage
afin(es)     = voisin(s) / commun, similaire
afinar       = accorder, poser, peaufiner,
               ajuster, affiner
aflojar      = desserrer, donner du mou, filer
               baisser, tomber, se calmer
afrancesado  = très français
agárrar      = saisir, attraper, prendre
agasajar     = recevoir chaleureusement,
               bien accueillir, fêter
agasajo      = festin, banquet
agazapar     = cacher
agilizar     = faciliter
aglutinar    = agglutiner / regrouper,
               conjuguer, rassembler
agorero,a    = augure, devin, prophète
agorero,a    = de mauvais augure
agotado      = épuisé
agradar      = être agréable, plaire
agradecer    = remercier, apprécier
agradecido   = reconnaissant
agrado       = plaisir / complaisance
agredir      = agresser, attaquer
agregar      = ajouter
agregarse    = rejoindre
agreste      = sauvage
               agreste (rustique)
agridulce    = aigre-doux
aguacate     = avocat(fruit), avocatier
aguacero     = averse
aguachirle   = lavasse (café)
aguada       = gouache
aguado,a     = coupé, trop liquide, gaché
aguantar     = tenir, supporter, souffrir,
               retenir, résister
aguanté      = patience, résistance, endurance
aguardar     = être dans l'attente de, attendre
agudo,a      = pointu, aigu, grave, fort / vif,
               fin, perçant / spirituel
aguerrido,a  = agguerri(e), chevronné(e)
aguijón      = dard, épine, motivation
aguijonazo   = ?
aguijonear   = aiguillonner, titiller
agujerear    = percer, faire des trous
agujero      = trou
aguja        = aiguille, aiguillette, aiguillage
aguzar       = aiguiser, affiler, affiner
ahí          = là
ahijado,a    = filleul, protégé
ahogar       = noyer, étouffer, étrangler
ahorita, ahoritita = tout de suite
ahorrar      = économiser, épargner
ahuyentar    = faire fuir, chasser
airado       = irrité
aislado      = isolé
aislar       = isoler
ajedrez      = échecs
ajeno        = contraire, étranger
ajillo (al)  = avec une sauce à base d'huile,
               ail et piment
ajo          = ail 
ajo (estar en el ajo) = être dans le coup
ajustador = pieza ajustadora = pièce manquante
ajustador    = typographe
ajuste       = ajustage, façonnage, réglage
alamar       = brandebourg, frange
alamares     = ?
alargar      = allonger, rallonger, prolonger,
               passer
alarido      = hurlement
albergar     = héberger, loger / nourrir
albergue     = hébergement, refuge
alborozar    = transporter de joie
alborozo     = débordement de joie
alcaide      = directeur de prison
alcantarilla = égout
alcance      = portée
alcanzar     = atteindre, rattraper, passer,
               obtenir
alce         = élan
alcé         --> alzar
alcoba       = chambre, alcôve, boudoir
alcoba       = voiture-couchette, voiture-lit
alcolifán    = ?
alcurnia (de) = de haute lignée
alejar(se)   = éloigner (s')
alentar      = encourager
alevosía     = traitrise
alevoso/a    = prémédité, traitre, traitresse,
               fourbe
alfombra     = tapis
algarada     = razzia, incursion / brouhaha
álgido       = culminant / glacial
aliento      = haleine / d'une seule traite
               courage
alimaña      = animal nuisible
aliñar       = assaisonner
aliño        = assaisonnement
aliviar      = calmer, atténuer, apaiser,
               alléger
aljibe       = citerne, bateau-citerne
allegado     = proche
almacén      = magasin
altanero,a   = hautain
alumbrar     = éclairer, allumer
alumbrar     = mettre bas, enfanter
               concevoir
amainar      = amener
amainar      = se calmer, faiblir, passer
amasar       = pétrir, gâcher (platre), masser
álamo        = peuplier
almendro     = amandier
almíbar      = sirop
almibarada   = mielleuse
almorzar     = déjeuner, prendre un en-cas
almuerzo     = déjeuner
alojar       = loger
altura       = hauteur, haut / altitude / niveau
altura (a estas) = date (à cette), heure actuelle (à l')
alucinar     = délirer, rêver, halluciner
               épater
alud         = avalanche (literal & figurado)
aludir       = faire allusion à, évoquer
alzar        = lever, élever, hausser, relever
               élever, soulever
amable       = aimable
amago        = signe avant-coureur / menace
amanecer     = lever du jour, 
               commencer à faire jour
amargo       = amer
amenazar     = menacer
ametralladora = mitrailleuse
amoldar      = adapter
amontonar    = entasser, accumuler, amasser
añagaza      = appeau / artifice, leure
anaranjado,a = orangé
ancho        = largeur
ancho,a      = large
anclado      = ancré
anclaje      = ancrage, mouillage
andadera     = trotteur (pour marcher)
andar        = marcher / parcourir
andrajo      = guenilles, loques
anegar       = noyer, inonder
angosto      = étroit
anilla       = anneau, anneaux
anillar      = anneler / garnir d'anneaux
ánimo        = courage
               avec l'intention (con ... de)
aniquilar    = anéantir, exterminer
anjá         = ?
anómalo,a    = anormal
añoranza     = nostalgie, regret, mal du pays
antesala     = hall, antichambre
anticipar    = avancer, anticiper
apacible = pasible, doux
apaciguar = apaiser
apagar = éteindre, calmer, étancher
apagón = coupure, panne de courant
aparato = appareil, machine, dispositif, agrès
apartar = écarter, séparer, mettre de côté
apartarse = se pousser, s'éloigner de, s'écarter de
apenàs = peine (à), tout juste, dès que
apestoso,a = puant
apetecible = appétissant, tentant
ápice = iota
ápice = sommet, extrémité, haut, bout
aplastar = écraser
aplazar = reporter, ajourner
aplomo = aplomb, assurance, confiance
apoderar = déléguer ses pouvoirs à
apoderarse = s'emparer de
apodo = surnom
apostador = ?
apostar = parier, poster
apostillar = apostiller (mettre une apostille)
apremiar = presser, bousculer / contraindre, obliger
aprendiz = apprenti, débutant
apretar = serrer, appuyer sur, presser, tasser, pincer, redoubler
aprieto = situation difficile
aprovechar = récupérer, se servir de
apuntar = noter, pointer, souffler, évoquer, signaler, souligner
apuntar = poindre
apuntarse = s'inscrire, être partant
apunte = annotation, croquis, esquisse, souffleur, mise
apurar = finir, épuiser, inquiéter, gêner
apuro = gros ennui, manque d'argent, gêne
aquejar = affliger
aquello = ce, cela, ça
por aquello de que = c'est pour cela que
araña = araignée / lustre
arañar = griffer / égratigner, érafler / grapiller
arder = brûler
argüir = arguer, prouver, argumenter
arpía = harpie
arrancar = arracher, déraciner, retirer, enlever
arrancar = démarrer, lancer, partir
arrasar = dévaster, ravager
arrastrar = remorquer, trainer, entrainer, convaincre
arrebatar = arracher, fasciner
arrebatarse = s'emporter
arredrar = séparer
arredrarse = s'avouer vaincu, se rendre, reculer
arreglar = arranger, régler, préparer, pomponner
arremangar = retrousser, relever
arrojado,a = courrageux, intrépide
arrojar = jeter / cracher / dégager / chasser / rendre (vomir)
arroyo = ruisseau, caniveau
arroz = riz
arruga = pli, ride
arrugar = froisser, chiffonner, rider, froncer
artesano = artisan
artesiano = ?
asaltar = attaquer, assaillir, venir, prendre d'assaut
ascenso = avancement, promotion, ascension
asco = dégoùt
asediar = assiéger, harceler
asegurar = assujettir, resserrer, assurer
asemejar = faire ressembler à, se ressembler
asentir = admettre / acquiescer
asesino = assassin
aseveración = affirmation, assertion
así = ainsi
asimismo = aussi, de même, de la même manière, également
asolador = dévastateur, destructeur
asolar = dévaster, ravager
asomar = apparaitre, sortir, dépasser, passer
asomarse = se pencher à
asombrar = stupéfier, étonner
asombro = stupéfaction, étonnement
asombroso = stupéfiant, ahurissant
aspa = aile (de moulin), pale
aspar = dévider / mortifier, tourmenter
aspereza = rugosité, aspérité / âpreté, rudesse
áspero,a = rugueux, raboteux / âpre, acerbe / revêche
asquear = dégoùter
asta = haste, lance, pique
astuto,a = astucieux / rusé
asunto = sujet, affaire, liaison
asustar = effrayer, faire peur à
atacar = attaguer, être surpris(e) par, critiquer, s'en prendre à, combattre
atragar = ?
atajar = couper court à / enrayer, maitriser, couper / prendre un raccourci
atajo = raccourci / bande, ramassis
atar = attacher
atalaya = tour de guet
atenazar = empoigner, tenailler
ateneo = cercle (association)
atenter = attenter
aterrar = renverser, jeter à terre, atterrer, effrayer, terrifier
atiborrar = bourrer
atiborrarse = s'empiffrer (de)
atisbar = observer / distinguer, entrevoir
atisbo = soupçon, début / moindre / lueur, filet de lumière
atónito,a = sans voix, stupéfait
atormentar = torturer
atrapar = attraper, décrocher, rouler
atrás = derrière, arrière (à l') / arrière (en) / tôt (plus), avant
atrasado = retard (en) , traîne (à la), arriéré, retardé
atreverse = oser
atrevido = effronté, intrépide, osé
atronar = ?
atropellar = renverser / piétiner, marcher sur
atropellarse = bredouiller
atusar = tondre / lisser
atuzó -> atusó
atusó -> atusar
augustino,a = augustin(e)
aula = salle de classe, salle de cours
aun = même, bien que,
ausencia = absence, carence, manque
avalar = avaliser, donner son aval à
avanzadilla = avant-garde
avecinarse = approcher, être proche
aventón = dar un aventón a = déposer quelqu'un
avergonzar/se = faire honte / avoir honte de
averiguar = rechercher, chercher à savoir
avinguda (Catalan ?) = avenue, allée
avisar = prévenir / appeler
aviso = avertissement / avis, appel
azafrán = safran
azar = hazard
azotar = frapper, fouetter / s'abattre sur
azotea = terrasse / ciboulot
azulejo = carreau de faïence

B
bache = trou, nid de poule, ornière
baches = moments difficiles, les hauts et les bas
baile = bal, fête, soirée dansante
bajar = descendre, baisser
bala = balle
balazo = balle, coup de feu
baldío/a = inculte, vain
baldosa = carreau, dalle
baldosar = carreler, daller
bandeja = plateau
bandera = drapeau, bannière
barbaridad = atrocité, ineptie
barnizar = vernir
barojiano,a = relatif à Pío Baroja (romancier) ou son œuvre
barranco = précipice, ravin
barrer = balayer, battre à plate couture
barriendo -> barrer
barriga = ventre
barro = boue / argile / acné
barruntar = deviner, pressentir, prévoir
bastar = suffire
bata = robe de chambre, blouse
batido = battu
baúl = malle, coffre
beato,a = dévot, béat, bigot, Bienheureux
bellaquería = friponnerie, méfait
berro = cresson
bestia = brute, bête
bisoñé = toupet
bizquear = loucher / être épaté
blancuzco,a = blanchâtre
blandir = brandir
blúmer = ?
bocado = bouchée / bout, morceau
bocajarro,a = brûle-pourpoint (à) / bout portant (à)
bodega = cave/bar à vin
bodega = soute, cale
bodega = épicerie, magasim (América)
boina = béret
boligrafo = stylo-bille
bolitas = billes
bolsa = sac, bourse, poche, bouillotte
bolsillo = poche
bonanza = calme plat / prospérité
bordear = border, longer, friser, frôler
borla = pompon / gland (insigne)
borrar = effacer, gommer, rayer
borroso,a = flou / effacé (à moitié)
bostezar = bailler
bostezo = bâillement
botar = lancer (bateau), virer, jeter, sauter, rebondir
bote = canot
braga = culotte
bravucón(a) = bravache, fanfaron
breñal = ?
breve = bref
brincar = sauter
brinqué -> brincar
broma = plaisanterie
bronca = bagarre, huées
bronco/a = grossier, rauque, rustre
brotar = pousser, jaillir, naitre, sortir
brote = pousse, bourgeon / médecine : accès, foyer, éruption
brumoso,a = brumeux
buhonero,a = camelot, marchand ambulant, colporteur
buitre = vautour (~requin)
bullicio = brouhaha / agitation, animation
bulto = bosse, masse, silhouette, paquet
buñuelo = beignet / horreur (figuratif)
burlar = semer, esquiver / tromper / se moquer
burlón = blagueur, plaisantin / moqueur, railleur, taquin
burro/a = âne, ânesse / bête
butaca = fauteuil, place
butacón = grand fauteuil
butifarra = boudin catalan, saucisse catalane (Languedoc : boutifarre)
butifarra = bas trop larges / foire, fête
buzo = plongeur, bleu de travail

C
cábala = cabale / prédiction, divination / hypothèse, conjecture, supposition
caballeresco,a = chevaleresque
cabeceo = hochement / cahots, tangage
cabecilla = meneur, meneuse, leader
cabizbajo = la tête basse
cabo = cap, bout, cordage, / caporal, brigadier
cabrales = fromage bleu des asturies
cabrón = enfoiré / cocu / bouc
cacería = partie de chasse
cachorro = chiot / petit (de mammifère)
cadera = hanche
cagar = chier / foutre en l'air, mettre les pieds dans le plat
cainita = ?
caja = boite, caisse, boitier, coffre, cercueil
cajetilla = boîte, paquet / dandy
cajon = tiroir, caisse
calcetin = chaussette / tirelire
calcular = calculer / croire
caldo = bouillon / consommé, jus de cuisson / vin / bain
calentar = chauffer, s'échauffer / frapper
caleo = ?
caleta = ?
Caleta = ville des Canaries
caliqueño = cigare (marque)
caliza = calcaire
callejero = de la rue, ambulant / répertoire des rues
calzada = chaussée
calzar = chausser
calzon = slip
calzoncillos = slip
camarón = crevette
campamental = ?
campamento = camping / campement / troupe
campanudo = pompeux ?
cana = cheveu blanc
cana al aire (echar una) = payer une partie de plaisir (se)
candelabro = candélabre (chandelier, réverbère)
candoroso = candide
canje = échange
canjear = échanger
canoso/a = grisonnant/e
cansancio = fatique
cantimplora = gourde
canturrear = fredonner, chantonner
capilla = chapelle
capitular = capituler
capítulo = chapitre / llamar a capítulo = demander des comptes
capote = capote, cape
capote a alguien (echarle un) = coup de main (donner un)
cara = face
carajo = bordel !
carajo (me importa un carajo) = rien  à foutre
carajo (irse al carajo) = aller se faire voir
carcelero,a = maton, matonne, gardien de prison, geôlier
carcelero,a = carcéral
carcomer = ronger, consumer
carcomido/a = vermoulu, rongé
carecía = ?
carecer de = manquer de
cariño = affection, tendresse / soin / chéri(e) !
carnada = appât
carnet = carte (identité, permis), agenda
carozo = noyau
carpeta = chemise
carrer = ?
carrera = course / parcours / études / échelle / carrière
carro = voiture, automobile / charion, caddie
carrozón = personne vieux-jeu dans ses gouts (habillement, musique)
cartel = affiche / de cartel = de renom
cartera = portefeuille / porte-documents, serviette, cartable
casaca = casaque / queue-de-pie
casco = casque
caserón = bâtisse
casilla = guichet / casier / case / boite postale
caspa = pellicules (cheveux)
castigar = punir, endommager, frapper, mortifier, malmener / séduire / pénaliser
castigo = punition, épreuve, pénalité
castitad = chasteté
castrense = militaire (adj.)
casual = fortuit
casuarina = [espèce d'arbre/arbuste] ?
cauce = lit, canal, cours
cautivar = capturer / captiver
cautiverio = cautividad
cautividad = captivité
cauto = prudent
cavar = creuser, bêcher, biner
cavilación = réflexion, méditation
cayo = ilôt bas et sablonneux
cazo = casserole / louche / portion, bol
cazuela = ragout
cebolla = oignon / filtre, crapaudine
ceder = céder
cediese -> ceder (1era persona imperfecto subjuntivo)
cegar = aveugler / boucher, murer
ceiba = fromager
ceja = sourcil / sillet
cejar = renoncer
celda = cellule
cenar = diner
cenicero = cendrier
cenicienta = bonne à tout faire / cendrillon / petit poucet
ceniciento,a = cendré / cuisant
ceñido,a = ajusté / pédiculé / économe
ceñir = mouler / ceinturer / entourer, encadrer
ceniza = cendre
cerca = clôture
cerca = près, proche
cerciorar = assurer
cerciorarse = s'assurer
cerdo = porc, cochon / salaud, connard, enfoiré
cerebro = cerveau, cervelle / tête (figuratif)
cerilla = allumette
cerradura = serrure
certeza = certitude
cervecero,a = de la bière / brasseur (euse)
cese = arrêt, cessation / renvoi, révocation
chaleco = gilet
chapa = plaque, capsule, badge, jeton, serrure (américa)
chaparrón = averse
chaqueta = veste, cardigan
charco = flaque d'eau
charla = bavardage, causerie, discours
charlar = bavarder
chasquear = faire claquer / jouer un tour, tromper / craquer
chatarra = ferraille, camelote
chatura = ?
checa = comité de la police secrète
checo,a = checoslovaco,a
checoslovaco = tchèque
cheque = chèque
chicharo = petit pois
chiquillo,a = gamin, gosse, marmot, bambin
chocho,a = gâteux / gaga
choque = collision, carambolage / affrontement, bagarre
chorreo = écoulement, ruissellement, flot, perte
chorreón = écoulement, filet, jet, giclée, tache
chorro = jet, filet, flot
chucho = clébard, cabot, bâtard / radin, rat
chupada = goûter / coup de langue, léchage / pipe, turlupe / fumée, taffe
chupado,a = épuisé, éreinté, claqué / difficile / enlevé, séquestré
chupar = lécher / boire, picoler / s'imbiber, absorber
chusco,a = cocasse
chusco = quignon (de pain)
ciego,a = aveugle
cintura = taille, ceinture
cita = rendez-vous / citation
claro = clair
claro = vide, place libre, clairière, éclaircie
clavado = cloué, sonnant, planté
clavar = planter, clouer, épingler, fixer (yeux)
cloasma = chloasma (maladie) ?
cobarde = lâche
cobijo = refuge, abri
cobrar = encaisser, toucher, être payé
cobre = cuivre / sou
cobro = encaissement
cochino,a = cochon, sagouin, dégoutant
coger = prendre
cogollo = bourgeon, cœur / crème
coincidir = coïncider, concorder / être d'accord
cojear = boiter, être bancal, battre de l'aile, clocher
cojo,a = boiteux, bancal
cojones = couilles
cola = queue / traîne / colle
colación = collation
colada = lessive
colado/a = filtré / en pincer pour (estar colado por alguien)
colar = filtrer, passer, écouler (fausse monnaie), faire croire à, glisser, introduire
colar = prendre
colcha = couvre-lit
colega = collègue, confrère
coletazo = coup de queue
colilla = mégot
colmo = comble
colocar = placer, mettre
columpiar = balancer
columpio = balançoire
comarca = région
cometer = commettre
comensal = convive
comisura = commissure
comodidad = confort, commodité
compartir = partager
complacer = rendre heureux, faire plaisir
componer = composer / arranger, réparer / décorer, parer
comprobación = vérification
comprobar = vérifier
compuesta -> componer
compugido  = ?
compungido,a = contrit
compungir = affliger
computar = calculer, compter
comulgar = communier / partager
concebir = concevoir
concha = coquille, carapace / écaille / chatte (vulgaire)
concreto = concret, précis / béton
conde = comte
condesa = comtesse
condesita = ?
conejo = lapin
confesarse = avouer, se confesser
conformar = conformer
confusionismo = confusion
conjeturar = conjecturer
conjura = conspiration, conjuration
conminar = sommer, obliger, exhorter, presser
conmovedor(a) = émouvant(e)
conmover = émouvoir, ébranler
coño = con
consabido = classique, traditionnel
consagrar = consacrer, sacrer
conseguir = obtenir, atteindre
conserje = concierge / gardien
conspicuo,a = illustre, remarquable
consuelo = consolation, réconfort / soulagement
consuetudinario,a = consuétudinaire (en rapport avec le droit coutumier)
contender = rivaliser, lutter
contener = contenir / retenir
contienda -> contender
contienda = combat, conflit
contraseña = mot de passe
contrastar = contraster, trancher / éprouver, résister à
conveniencia = convenance, bénéfice, avantage
convivir = cohabiter, coexister / passer du temps avec
corbata = cravate
corcho = liège / bouchon
cordero = agneau
correa = courroie, bracelet, laisse, anse, ceinture
corredor = coureur, courtier / corridor
corregir = corriger / déféquer
correoso/a = caoutchouteux, mou / coriace
correr = courir / couler / passer / se propager / avoir cours
correria = incursion, raid, voyage rapide
corriente = courant, ordinaire
corro = cercle, ronde / corbeille (bourse)
cortado,a = gercé / tourné (lait) / timide, coincé / haché
cortar = couper
corte (la) = cour (faire la cour à)
cortesano = cour (de là), cour (à la)
cortesano,a = courtisan / serviteur dévoué
cortesano,a = courtois
cortina = rideau
corvina = espèce de poisson ?
cosechar = récolter, moissonner / obtenir
coser = coudre / agrafer
cosido,a = cousu
cosido = couture
costado = flanc, côté
costar = coûter / prendre (du temps)
costillar = cage thoracique, flanc / carré (de viande)
creer = croire
cretona = cretonne
creyera -> imperfecto subjuntivo creer
criado,a = domestique / élevé / causer, produire / grandir, devenir
criar = nourrir, alimenter / élever
cristalera = armoire à glace / verrière / porte vitrée
cristalino = cristallin
cuaderno =  cahier
cuajar = cailler (lait) / aboutir, tenir
cuantioso = nombreux
cuartear = diviser / dépecer, couper en quartier
cuartearse = se lézarder, se fendre, se crevasser
cuartel = quartier général / caserne / quartier
cubertería = couverts / ménagère
cubículo = chambre
cubilete = gobelet
cucharada = cuillérée
cuchipanda = ripaille, bombance
cuello = cou, col, goulet
cuentista = conteur / menteur
cuento = conte, histoire
cuerda = corde / ressort (horloge)
cuerdo = raisonnable, judicieux / un sage
cuero = cuir
cuesta = côte
culata = culasse, croupe
cumplir = accomplir, exécuter, tenir, respecter / avoir / purger, faire
cumplir = expirer / faire son devoir
cuneta = caniveau / fossé
cuñado,a = beau-frère, belle-sœur
cuña = cale, coin
cuña (tener) = avoir du piston
cuño = poinçon
cuota = cotisation / frais / quote-part / audimat
curda = cuite (familier)
curdo/a = rond(e) / soulard(e)
cursilería = mauvais goût / manières, snobisme
cursilería = bibelot
curtido = tannage
curtido,a = tanné / expérimenté, chevronné
custodia = garde / ostensoir
cuyo/a = dont le/la

D
dado = donné
dañar = abimer / faire mal, blesser / nuire à
daño = dommage, dégat / mal, blessure, plaie, douleur, souffrance
dar = donner
daiquirí = ponche
débil = faible / affaibli
debilitar = affaiblir
decimonónico = du 19ème siècle / dépassé
deducir = déduire
deduje -> deducir
defección = défection
dejar = laisser, quitter, abandonner
delatar = dénoncer / trahir
delgado = mince, maigre / fin
delibarodo,a = délibéré
demacrado = émacié, décharné
demás = autre / autres (les), reste (le) / à part ça (por lo ..)
demás (por lo ..) =  part (à ... ça)
demorar/se = retarder / s'attarder
deparar = présenter, causer, procurer, offir
deportivo,a = sportif / sport, fair-play / de plaisance
depositar = déposer
derramar = répandre, renverser
derredor = tour, contour
derribar = démolir, abattre, renverser
derrota = échec, défaite / route (Nautique)
derrotar = battre, vaincre, accabler / dériver
derrotero = chemin
derrumbar = démolir, abattre / s'effondrer
desafiar = défier
desaforado,a = démesuré, épouvantable, acharné
desaforar = léser / destituer, exclure
desafortunado = malchanceux, malheureux
desahuciar = condamner
desalentar = décourager, rebuter
desalentador = décourageant, démotivant
desaliento = découragement, abattement
desalmada = sans-cœur
desaprensivo,a = sans-gène
desasosiego = trouble
desastroso = désastreux, nul
desatar = détacher, déchainer, délier
desazón = fadeur / peine, ennui
desbocar = casser, briser / se jeter dans, se déverser dans
desbocarse = s'emballer / prendre la main, embarquer / flamber (prix, cours)
desbordar = sortir de, dépasser, pousser à bout, déborder
desbrozar = débroussailer / désherber
descanso = repos, congé, vacances, soulagement / entracte, pause / palier
descarado = effronté
descararse = parler ou agir avec insolence ou effronterie
descargo = déchargement / excuse, décharge, reçu
descojonarse = se poiler, se marrer / se foutre de qque chose, qqu'un
descomunal = énorme, immense, colossal
desconchado = écaillure
desconchado,a = dêcrépi, écaillé
descontar = déduire / rabattre / escompter
descortés = impoli
descreído,a = incroyant,e
descuido =  négligence, inattention
desdén = dédain, superbe
desdeñar = dédaigner
desdichado = malheureux, pauvre / malchanceux / peureux, trouillard
desempeñar = remplir, exercer / jouer / dégager
desengañar = informer correctement, ouvrir les yeux
desengañar = déchanter, tomber de haut, perdre ses illusions
desenganchar = décrocher, dételer
desenlace = dénouement
desesperanzador,a = désespérant
desfogar = décharger, donner libre cours à / faiblir, se calmer
desgarrón = déchirure
desharrapado = en haillons, déguenillé, va-nu-pieds
deshacer = faire fondre / défaire / abattre, briser / fermer, liquider
deshecho = déchet / détruit, en miettes / défait
desidia = laisser-aller
designio = dessein, volonté, plan, projet
deslealtad = déloyauté
desleír = délayer
deslizamiento = patinage, glissement
deslizar = glisser, faire glisser / insinuer
deslizarse = se faufiler, s'introduire / se déplacer
deslumbrante = éblouissant
desmán = excès, abus, agissements
desmemoriado = qui a mauvaise mémoire
desmemoriarse = perdre la mémoire, oublier, ne pas se rappeler
desmoronar = abattre, faire ébouler, décourager
desmoronarse = s'écrouler, s'effondrer, se décourager
desolador = désolant, navrant, attristant
desollar = écorcher, ruiner
desorbitadamente = ?
desorbitar = grossir / sortir de son orbite, s'envoler
despachar = vendre / servir / congédier / traiter / régler / expédier
despachar = avoir un entretien / servir
despacho = bureau / vente / guichet / dépêche, mandat / envoi
despacio = lentement, doucement
despacioso -> despacio ?
despampanante = canon, épatant
despavorido,a = épouvanté
despechar = énerver / insulter / sevrer
despecho = dépit
despedida = adieux, renvoi, congé, licenciement
despedir = faire ses adieux, jeter, renvoyer
despejar = dégager, débarasser / clarifier, éclaircir, dissiper
despejarse = se dégager / se changer les idées
despellejar = dépouiller, écorcher, dépecer, peler, éplucher
despellejar = dire du mal (de qqn)
desperdigado = dispersé, éparpillé
desperdigar = éparpiller
desperezarse = s'étirer
despertar (un) = réveil
despertar = réveiller, éveiller, provoquer
despiadado = impitoyable
desplante = insolence
desplomarse = s'effondrer
desplome = écroulement, saillie
despojar = dépouiller
despojarse = se priver de, se dépouiller de
despreciable = ?
despreciar = mépriser, rejeter
desprender = détacher, décoller, dégager, diffuser
desquiciado = fou, taré, cinglé
desquiciar = rendre fou, faire sortir de ses gonds
destacar = souligner, détacher, ressortir, se distinguer
destartalado,a = démantibulé, délabré / déglingué
destello = éclat, scintillement / lueur
destreza = habileté, adresse
destripar = étriper, désosser
destrozar = abimer, détériorer, détruire
desvaído = pâle, passé / vague, flou
desvalimiento = abandon, délaissement
desvanecer = effacer, éteindre, dissiper / faire disparaitre, mettre fin, couper court
dervanecerse = s'évanouir, perdre connaissance / se dissiper, disparaitre
desvelar = empêcher de dormir, dévoiler, se coucher tard
desvelo = insomnie / effort
desvencijado = délabré
desventrada = ?
desventurado,a = malchanceux, malheureux, infortuné / sans esprit / avare
detallismo = méticulosité / commerce au détail
detenerse = s'arrêter
devolver = rendre, rembourser, renvoyer, remettre
di -> dar / decir
diáfano = diaphane, translucide / clair, limpide
diario = quotidien, journalier / journal
difuminado = estompé
difundir = diffuser, répandre
dilatar = dilater / faire durer, prolonger
dilatado,a = dilaté / vaste
dintel = linteau / limite, seuil
dirimir = résoudre, trancher, annuler
discrepencia = divergence, désaccord
discurrir = passer, s'écouler / se dérouler / réfléchir, concevoir, inventer
diseñar = dessinner / concevoir
diseño = dessin / conception
disfrace = ?
disfrazar = déguiser
disfrutar = jouir, profiter, s'amuser
disparo = coup de feu, tir
displicencia = indifférence, froideur / découragement / nonchalance
displicente = déplaisant, désagréable / acrimonieux, acerbe, aigre / nonchalant
disquisición = exposé
disyuntiva = dilemme
ditirambo = dithyrambe (cantique, louange, panégyrique)
divisar = apercevoir, dicerner, entrevoir
dolencia = douleur
dramatismo = intensité dramatique
dudar = douter / hésiter
dudoso = improbable / hésitant / douteux
dueño = propriétaire
dulzona = ?
dulzor = ?

E
echar = lancer, jeter, mettre, faire
echarse a perder = s'abimer, tourner mal
efímero,a = éphémère
egipcio = égyptien
eludir = éviter / esquiver / ignorer
embalsamador = embaumeur
embargar = saisir, paralyser
embarrado = plein de boue, crotté
emboscado,a = embusqué
emboscar = embusquer
embotar = émousser, abrutir
embriaguez = ivresse
embuste = mensonge
empapar = tremper / éponger / boire, absorber
empecinado = fabricant ou vendeur de poix
empecinado,a = têtu, obstiné
empecinarse = se buter
empeñado = gagé
empeñar = mettre en gage, donner, engager, s'endetter
empeño = mise en gage / acharnement
empinado = raide, escarpé, abrupt / sur la pointe des pieds / envolé
empotrado = encastré
empresario,a = entrepreneur, patron
empujar = pousser
empuje = poussée / verve, vivacité, allant, entrain
empuñar = empoigner, braquer
enardecer = enflammer, motiver
encabezar = être en tête de, mettre l'entête à
encabronarse = se mettre en colére, se foutre en rogne
encajar = emboîter, faire entrer, ajuster, remettre, essuyer, encaisser
encaje = dentelle
encallar = échouer
encallarse = rester lettre morte
encallecer = devenir calleux / durcir, endurcir
encaramar = jucher
encargar = charger (quelqu'un de quelque chose) / commander
encarnizar = acharner / rendre cruel
encarnizado,a = archarné
encasquetar = asséner, enfoncer sur la tête
encauzar = canaliser / mener, orienter
encender = allumer, enflammer / provoquer
encerrar = enfermer
encharcar = détremper
encía = gencive
encierro = réclusion, mise au toril
encima = dessus, en plus
encina = chêne vert
encoger = faire rétrécir / contracter / rétrécir
encogimiento = rétrécissement / timidité
encono = animosité
encrucijada = croisement, carrefour
encuadernador,a = relieur(se)
encuadernar = relier
encuerar = ?
enero = janvier
enfáticamente = ?
enfático = emphatique, solennel, grandiloquent
enfermar = contaminer, rendre malade
enfermizo,a = maladif, insalubre, malsain
enfisema = emphysème (médecine : gonflement cellulaire ou pulmonaire)
enflaquecer = maigrir / amaigrir, faire maigrir
enfocar = faire la mise au point de / braquer, diriger / aborder (figuratif)
enfrascado = absorbé
enfrentar = affronter / opposer / mettre face à face
enfundar = rengainer
enfurecer = rendre furieux
engalanar = parer, pomponner, décorer, se faire beau
engañar = tromper
engaño = tromperie, mystification
engañoso,a = trompeur
engavetado = ?
engreído,a = suffisant
engrosar = augmenter / faire grossir, épaissir / grossir
engullir = engloutir
enmarañar = emmêler, enchevêtrer
enmarañado = emmêlé, en bataille / confus, embrouillé
enredadera = grimpant / liseron
enredar = emmêler, embrouiller / trafiquer, intriguer, faire des bêtises
ensañar = rendre furieux
ensayo = répétition, test, essai
enseres = affaires, effets personnels / matériel
ensortijado = bouclé
entablar = commencer, engager, entamer, amorcer / nouer
entelar = entoiler ?
enterado = averti, expert
entibiar = faire tiédir, attiédir / freiner, modérer, affaiblir
entierro = enterrement
entonces = alors
entradilla = titres
entrañable = cher, profond, attendrissant
entrañablemente
entresijos = dessous (les)
entregar = remettre, livrer, se rendre
entretela = triplure, bougran, entretaille
entreverado = entremêlé
envenenar = empoisonner, envenimer
envolver = envelopper, enrouler, enjôler
enzarzar = envenimer
enzarzarse = s'emmêler dans des ronces / se disputer
equivocar = confondre
erguir = dresser, redresser, lever
erizamiento = hérissement
erizao = ?
erizar = hérisser
escabroso = inégal, scabreux, délicat
escalinata = perron
escama = écaille, paillette, squame (peau)
escampar = cesser de pleuvoir
escaparate = vitrine
escaramuza = escarmouche
escatimar = lésiner sur, réduire, diminuer, épargner, ménager
escaso = maigre, faible, rare
escena = scène
escenografia = scénographie
escoger = choisir
escoltar = escorter
esconder = cacher
escondite = cachette, cache, cache-cache
escondrijo = repaire, cachette / coin caché
escopeta = fusil (de chasse)
escozor = brûlure, piqure
escriba (un) = scribe
escribir = écrir
escroto = scrotum
escritorio = bureau, secrétaire (meuble)
escrúpulo = scrupule / dégoût / méticulosité / scrupulums
escrutinio = dépouillement du scrutin / examen
escuálido,a = décharné, émacié, maigre
escudo = bouclier / blason, armes / écu
escuetamente = ?
escueto = simple, modeste, dépouillé
escueto = petit, succint, mini
escupir = cracher
escupitajo = crachat
ese,a = ce, cette, ce ...-là, ces, ces ...-là
ése,a = celui-là, celle-là, lui, elle,
esencia = essence, parfum / essentiel
esforzar = forcer, faire des efforts
esfumar = estomper
esfumarse = s'envoler, s'évaporer / disparaitre, se volatiliser
esmero = soin, application
espalda = dos
espantar = faire fuir, épouvanter
espanto = frayeur, effroi / fantôme / horreur
espantosa = épouvantable, horrible, terrible
espejuelo = gypse, lamelle de talc, miroir aux alouettes, reflet
espejuelos = lunettes, verres de lunettes
espesisimo = ?
espesar = épaissir
espeso = épais
espesura = fourré / épaisseur, densité
espetar = embrocher / traverser, percer / sortir, débiter
espigado,a = monté en graine / élancé
espigar = glaner / faire un tenon / glaner, butiner / épier
espin = spin
espirar = expirer / exhaler
espolear = éperonner
espolón = ergot, môle, jetée, éperon (d'un bateau)
espolonazo = ?
espuela = éperon / aiguillon
espuma = mousse, écume
esquela = faire-part
esquella = ?
esquema = schéma
esquerra = ?
esquina = coin
esquinado,a = en coin / acariâtre
esquinar = former un coin / placer en coin / indisposer
esquisito = exquis
establo = étable
estallar = éclater, exploser
estallido = explosion, détonation
estampa = estampe, image / allure (aspect)
estampida = débandade
estampido = détonation, déflagration, explosion
estancia = séjour, pièce / ranch, ferme
estanque = étang
estanquillo = ?
estante = bibliothèque, rayon, étagère, étai
estanteria = rayonnage, étagères
estaquilla = chevillette
estirar = étirer, tendre, faire durer
estocada = estocade, botte (escrime)
estorbar = gêner
estrafalario = saugrenu (péjoratif), bizarre
estragar = corrompre, ravager, gâter, pervertir
estrago = ravage, dégât
estratega = stratège
estrechar = serrer
estrellar = fracasser, briser
estremecimiento = frémissement
estría = vergeture
estropear = abîmer, faire échouer
estrujar = essorer / serrer, enlacer / froisser / dépouiller, saigner
estrujarse = se creuser la tête
estuche = étui, coffret, trousse
estupendo,a = excellent, épatant
etílico = ethylique, en état d'ivresse
eufemístico,a = euphémique
éxito = succès / bestseller, tube / réussite
expediente = dossier, enquête
explanada = esplanade / terrain découvert
exquisitez = ?
exquisito = exquis, raffiné
extemporáneo,a = hors saison / hors sujet, déplacé
extenso,a = étendu / long / en détail
extraño,a = étrange, étranger, étonnant
extraviar = perdre
extremeño,a = d'Estrémadure

F
fabe = haricot
fachada = façade
falso,a = faux
faltar = manquer / rester (quedar)
fama = célébrité, réputation
fango = boue
fantasmón,ona = crâneur,euse
farol = réverbère, fanal, feu / bluff
farsante = comédien, imposteur (simulateur)
faz = face
fe = foi, confiance, certificat
fechar = dater
feo = laid, sale / affront
ferrobus = autorail, micheline
ferrocarril = chemin de fer
fiel = fidèle
figura = figure / silhouette
fijar = fixer
fijarse = faire attention
fijo,a = fixe, fidèle, sans faute
fila = file, rang
finca = propriété, immeuble
fingir = feindre / faire semblant
fláccido,a = flasque
flácido,a = flasque
flaco = maigre / mon coco, ma cocotte
flamente = ?
flaquear = flageoler, faiblir
flatulencia = flatulence
flatulento = flatulent
flechazo = coup ou blessure de flèche / coup de foudre
flema = lymphe, flegme
flojo,a = lâche, léger / faible, médiocre
flotar = flotter
flote = flottage / flot (à)
fluir = couler
fogón = fourneau, chaudière
foguear = nettoyer (une arme), habituer au feu, cautériser
follaje = feuillage
fonda = auberge
fondear = mouiller
fondo = fond / a fondo = à fond
forcejear = se débattre / se démener
forjador = forgeron / forgeur
forjar = forger
fornido,a = robuste
fortaleza = forteresse / vigueur / force, résistance
fosa = fosse
fosforero,a = relatif aux allumettes, allumettier
foso = fosse, fossé, tranchée, dessous
fracasar = échouer
fracaso = échec
fragor = fracas, grondement
fraile = frère, moine / blennie fluviatile
franquear = dégager / franchir / affranchir
frasca = ?
frasco = flacon
fregadero = évier
frenar = freiner, réfréner
frente = front / devant / de face / nez à nez
fresno = frêne
frigio,a = phrygien
frondoso,a = touffu, luxuriant
frondosisimo -> muy frondoso
fruición = plaisir, délectation
fugaz = fugace / étoile filante
fundamento = fondations, fondement, raison
furibondes = ?
furibundo,a = furibond, furieux / enthousiaste, fervent

G
gabán = pardessus
gafa = pied-de-biche, gaffe, lunettes
galardón = prix (récompense)
galeón = galion
gallardón -> galardón ?
gallego,a = galicien
gallo = coq / chef / couac / limande
gana = envie
ganancias = profits, bénéfices
ganas = envie, appétit
gancho = crochet / rabatteur, compère / portemanteau
garabatear = gribouiller
garganta = gorge
garito = tripot, boui-boui
garlopa = varlope (grand rabot)
garra = griffe
garrafa = carafe
garrapatear = griffonner, gribouiller
gaseoso,a = gazeux
gastar = dépenser / user / consommer
gastado,a = usé
gazmoño = prude
gazmoño (familier) = bégueule, sainte nitouche
gaveta =  tiroir
gavetero = ?
gemir = gemir
gestión = démarche / gestion
gilipollez = connerie
gime -> gemir (3° pers. sing. ind. y 2° pers. sing. imper.)
Ginebra = Genève
ginebra = gin
glorieta = rond-point / tonnelle
golpe = coup, accrochage
golpear = frapper
golpista = de coup d'état / putschiste
gordezuelo = ?
gordo,a [adj] = gros, gras, important (de poids)
gordo,a = gros, grosse / mon coco, ma cocotte / faire une scène (armar la ..)
gordo = gros lot
gorra = casquette
gorro = bonnet
gotoso,a = goutteux
gozar = se réjouir
grabado = gravure
grabadora = magnétophone
grabar = graver / enregistrer
gracia = grâce / drôlerie / gout / talent
granero = grenier
graznido = croassement, cri d'orfraie
gremio = corporation / camp
griterio = cris
grueso,a = gros, épais
grueso = épaisseur / le gros de
gruñir = grogner, gronder, ronchonner, grincer
guagua (América) = bus / bébé
guantazo = baffe
guaperia = bravade
guarecer = abriter
guirigay = charabia, brouhaha
guisa = manière, façon
guisar = cuisiner, cuire, préparer
gula = gloutonnerie
guyabo,a = beau gosse, belle fille / goyavier / goyave

H
habilidoso,a = habile
habilidosamente
halagador = flatteur
halagar = flatter
halago = compliment, éloge / flatterie
hallar = trouver
hallazgo = trouvaille, découverte
hambre = faim
harapiento = en haillons
hartar = gaver, fatiguer
hartazgo = indigestion
hebilla = boucle (ceinture)
hechizar = ensorceler, jeter un sort, envoûter
hechizo = sort, sortilège, ensorcellement, envoûtement
hechizo = charme, envoûtement
hechizo,a = fait maison, fait main
heder = empester
hedor = puanteur
helado = glace
helado,a = gelé, glacé, de glace
hemeroteca = bibliothèques de périodiques
heredar = hériter
herido = blessé
hermandad = fraternité / confrérie / jumelage
hermeroteca = ?
hervir = faire bouillir / bouillir, bouillonner, grouiller
hierro = fer / lame
hígado = foie / tener higado = avoir du cran
hilera = rangée
hilo = fil / filet / lin
hiperbólico,a = hyperbolique
hocico = museau, groin, gueule
hoguera = bûcher, feu de joie
hoja = feuille / lame / battant
hojear = jeter un coup d'œil à, feuilleter
hombría = virilité
hombro = épaule
honda = fronde
hondo,a = profond(e) / au plus profond de
hondonada = dépression (du terrain)
honrado,a = honnête
hormigón = béton
horrendo,a = horrible / atroce
hortaliza = légume
hostigar = gêner, déranger / harceler / écœurer
hoya = trou, cratère, vallée, cuvette, fosse, tombe
hoyo = trou, tombe
hueco = creux, place
huerfano = orphelin
hueso = os / noyau / peau de vache, bête noire / sinécure (América)
hule = toile cirée
humeante = fumant
hundir = enfoncer, plonger, couler / planter (ongle, griffe) / abattre (personne)
huraño,a = farouche
hurgar = fouiller

I
ideario = idéologie, doctrine, idéal, idéaux
idóneo,a = idéal, indiqué, bon
inducir = inciter, induire / conduire à, mener à
indujeron -> inducir
ilegible = illisible
impar = impair / sans paire
impartir = donner, répartir, dispenser (un cours)
impetu = fougue, force / élan, impétuosité, énergie
impetu = magnitude d'un vecteur
impoluto,a = immaculé, irréprochable
impostar = projeter / émettre un son (musique)
imprescindible = indispensable
inabarcable = trop vaste
inagotable = inépuisable
inalcanzable = inaccessible
inaplazable = qui ne peut pas être reporté -> aplazar
inatrapable -> ? atrapar
inaugurar = inaugurer
inconfundible = caractéristique
incipiente = naissant
incomodidad = ne pas être confortable, pratique
incorporar = incorporer, ajouter / asseoir, redresser
increpar = blâmer, injurier
indagación = investigation
indagador = investigateur
indumentaría = costume / vestimentaire
ínfulas = prétention, vanité
ingente = énorme
ingresar = déposer, mettre, verser / faire entrer / être admis / rentrer
inocuo = inoffensif, fade
inquina = aversion, rancœur
insidioso,a = insidieux
insinuar = insinuer / faire des avances, draguer
insulso,a = fade, insipide
intellectualidad = intellectualité / intellectuels
intemperie = dehors / belle étoile (à la) / intempérie
intentona = tentative téméraire
intricado = ?
intrincado = compliqué, complexe
intuir = avoir l'intuition de, pressentir
invernizo = hivernal
inverosímil = invraisemblable
irrechazable -> rechazar ?
irredimible = irrachetable

J
jabón = savon
jadeante = haletant, hors d'haleine
jadear = haleter
jalar = tirer, haler, attirer, bouffer
jamabar = ?
jarama = ?
jaramago = sisymbre (Bot.)
jarana = java, grabuge, émeute / guitare
jaspeado = jaspé
jerarca = hiérarque, dignitaire / dirigeant
jerarquía = hiérarchie
jerga = jargon, argot / paillasse / grosse toile
jipi = hippie ?
jirón = lambeau, bordure
joder = baiser, faire chier, emmerder, niquer
joder ! = merde !, putain !
jodido (vulgar) = mal foutu, emmerdé, foutu
jofaina = bassine
jornada = journée / étape
joseantonianos = ?
jubilado = retraité
jubilar = mettre à la retraite
jubilo = joie
judía = haricot
judío,a = juif(ive)
juerga = noce, foire, bombe, bringuek
jugar = jouer
jugo (de) = jus, suc
jugué --> jugar
juguetear = jouer
juntura = jointure, joint, articulation
juicio = jugement
juiciosamente = con juicio

L
labrar = cultiver, labourer, travailler
ladrar = aboyer, brailler
ladrido = aboiement, braillement
lacerante = aigu, blessant, déchirant
ladera = flanc, versant
ladero,a = latéral
laguna = lagune / lacune
lamentar/se = regretter, déplorer / se lamenter
lamer = lécher
lamía -> lamer ?
lámpara = lampe / tache (figuré)
lánguido = languide (langoureux, languissant) / fragile
lapiz = crayon
laquear = laquer
lasca = éclat de pierre
lástima = pitié, peine, dommage
lastimoso,a = qui fait de la peine, navrant, pitoyable, déplorable
lastrar = lester
lastre = pierre de mauvaise qualité / lest
lastre = handicap, obstacle / fardeau, gêne
lata = boite (de conserve) / casse-pieds
latir = battre
latoso = barbant, raseur
lauro = gloire, triomphe
lazo = nœud
lealtad = loyauté
lecho = lit, fond (lac, canal), couche
lechuza = chouette
lejanía = éloignement
lengua = langue / ir de lengua = ne pas tenir sa langue
letal = mortel
letra = lettre / écriture / traite / paroles
leve = léger, bénin, petit
levedad = légèreté, bénignité, petitesse
libra = balance
librar = livrer / faire, émettre, délivrer
librarse = s'échapper / se débarrasser de
librero = libraire, bibliothèque, du livre
libreta = carnet, livre de comptes
licuar = liquéfier
liderato -> liderazgo
liderazgo = première place, leadership
lidia = combat
lidiar = lutter, combattre
lima = lime, limettier
limar = limer, polir
limosna = aumône, charité
limpiamente = adroitement, proprement
lindar = être contigu, être en contact, toucher / flirter
lindar = être contigu, en contact, toucher, être bordé / flirter
linde = limite, frontière
lindero = limite
lindero,a = contigu
lindo,a = joli
linterna = lampe de poche
lista = liste / bande, latte / rayure
listo,a = malin, dégourdi / prêt
llama = flamme / lama
llamar = appeler, nommer, donner un nom / sonner, toquer / attirer, dire
llamarada = flambée, rougeur
llameante = flambant ?
llamear = flamber
llanura = plaine
llenar = remplir, combler
llevar = porter, transporter
llover = pleuvoir
locuacidad = loquacité
locura = folie
lograr = réussir, parvenir
loma = colline
lomo = dos, échine
losa = dalle / pierre, plaque / vaisselle
losar = daller, carreler
lote = lot, part
loza = faïence, vaisselle
luciar = briller
luego de = après
lujo = luxe

M
macarela = ?
macizar = rendre massif, boiser en plein
macizo,a = massif / baraqué
macizo = massif
maderamen = boisage
madriguera = tanière, terrier
madrina = marraine / témoin (mariage)
madurar = mûrir
maestrazgo = dignité, titre de grand maître (militar)
mago,a = magicien, enchanteur
malagradecido -> agradecido
malanga = ?
maldecir = maudire / pester, injurier, traiter de tous les noms / jurer
maldijo --> maldecir
malecón = jetée
maleza = mauvaises herbes / broussaille
malignidad = malignité
malogrado = décédé, défunt
malvado,a = méchant
mamey = ?
mampostería = maçonnerie
mancha = tache / la Manche
manchar = tacher / se salir
mandar = ordonner, envoyer, commander
manejar = manier, mener, gérer, conduire
manga = manche, tuyau, chausse, perche
mango = manche (anse, poignée) / manguier / mangue
manicomio = asile (d'aliénés)
manifiesto,a = manifeste
maniobra = manœuvre
manotazo = claque
manta = couverture / toile de coton, calicot
manta = cossard, flemmard, fainéant, paresseux / raie manta
mantel = nappe
maricón = pédé
marimacho = virago (femme d'allure masculine, autoritaire et criarde)
mármol = marbre
marrasquino = marasquin (liqueur)
masa = masse / totalité, total / pâte
masía = ferme (en catalogne)
mata = buisson, touffe
matanza = tuerie, massacre / abattage / porc de boucherie
mataperros = ?
matorral = fourré
mayimbes = ?
meapila = ?
mear = pisser
médano = dune / banc de sable
mediado, mediados (a) = moitié (à), mi / moitié (à la), mi (à la)
mediante = grâce à, moyennant, moyen (au .. de), aide (à l'... de), par
mediar = intercéder, intervenir
medida = mesure / dimension / part
mejilla = joue
melánico = ?
melcocha = ?
menesteroso,a = nécessiteux (-euse), pauvre
menestoroso = ?
mente = esprit, intention
mentira = mensonge
mentiroso,a = menteur,euse
menudear = répéter / abonder
menudo,a = menu, petit
menudo (a menudo) = souvent
merecer = mériter
mermelada = confitûre
mero,a = seul
mero = mérou
merodear = rôder
miedo = peur
miga = mie / miettes / substance, moelle
migaja = quignon de pain, miette
migar = couper le pain en petit morceaux
migas = ragoût de pain frit avec des lardon
milagro = miracle
militar = servir, militer
militar = militaire
militarote = ?
milla (la) = mille marin
mingitorio = urinoir
minifalda = minijupe
mirilla = judas (de porte)
misa = messe
mitin = meeting
mito = mythe / personnage, figure
mochila = sac à dos
mochilla -> mochila ?
mocho = balai-serpillière
mocho,a = émoussé, étêté, écorné
moco = morve
modorra = sommeil profond, engourdissement, assoupissement
mojar = mouiller, tremper
moler = moudre / épuiser, éreinter / faire chier, emmerder, fatiguer
molestar = gêner, déranger, faire mal
molesto,a = gênant / faché
molicie = ?
molido = moulu / épuisé, éreinté, harassé, flapi / roué de coups
momia = momie
monago = enfant de chœur
monaguillo = enfant de chœur
montón = tas
moro,a = arabe / musulman, musulmane / Maure
moro,a = noir / jaloux, possessif
mosén = mestre,meistre (commandant d'un régiment sous l'ancien régime)
mossèn = mot catalan : prêtre ?
mostrador = comptoir
motear = tacheter, moucheter
mudar = changer, muer
mudo,a = muet
mueca = grimace
muelle = quai
mullida -> mullir
mullir = assouplir
multitudinario = massif
muñeca = poignet / poupée / piston
musitar = marmotter
mutuamente = ?

N
nailon = nylon
naipe = carte (à jouer)
nalga = fesse
nato,a = né / de plein droit
nave = navire, vaisseau / hangar, nef
necio,a = idiot, sot
negar = nier, refuser
nerviosismo = nervosité
nexo = lien, rapport, liaison
nidal = nichoir, pondoir / nichet (œuf en plâtre ou marbre)
nitido = clair, net
nombramiento = nomination
nombre = nom / prénom / renom
noquear = mettre ko
noticiario = actualités / informations
novato = débutant
novelesco,a = romanesque
nube = nuage, nuée, taie (dans l'œil)

O
obligar/se = obliger / engager à (s')
obrar = faire, bâtir, construire / agir, trouver (se), être
obsequiar = faire cadeau, offrir
obsequio = cadeau
ocio = temps libre, loisir, divertissement
ocioso,a = oisif / oiseux
odiar = haïr, détester
odio = haine
óleo = huile
ombligo = nombrir
ominoso = horrible, répugnant / abominable, malheureux
onda = onde, ondulation
ordenar = ordonner, ranger, classer
orilla = bord, lisière, trottoir
orillar = atteindre le bord / border, arranger
orina = urine
oriundo = originaire, venir de
oriundo = sportif étranger dont le père ou la mère ne le sont pas
orsianos = ?
orteguiano
oscuro,a = obscur, foncé, sombre
ostentar = détenir, occuper / étaler, afficher, montrer
otoñal = automnal / âgé, âge mûr (d'), automne de la vie (à l')
otorgar = octroyer, attribuer, conférer
óxido = rouille, oxyde

P
padecer = souffrir de / supporter
paja = paille, foin / osier
paja (vulg.) = branlette
pajar = grenier à paille
pal = ?
pala = pelle / raquette, batte
paladar = palais
palurdo = lourdeau, grossier, balourd
pamema = histoire / minauderies / feinte
panadería = boulangerie
panadero,a = boulanger(ère)
pañado = poignée / quelques
panameño,a = panaméen(-ne)
pandilla = bande (d'amis)
pañete = petit drap, toile de mauvaise qualité, linge
panetela = ?
paño = tissu / torchon, serviette
pantalla = écran / abat-jour / paravent
pantano = marais, retenue d'eau
pantorrilla = mollet
pañuelo = mouchoir / foulard
papel = papier / rôle
papeleta = billet / affaire difficile / bulletin de notes
par = paire
paradero = endroit / oú qqn se trouve, habitte / fin, terme / arrêt
parafernalia = panoplie, attirail, gadgets
paraguas = parapluie
paraíso = paradis
pardo,a = brun / sourd / sombre, gris / mulâtre
pardo = léopard
paredón = gros mur / poteau d'exécution
pariente = parent, proche parent / moitié
parir = mettre bas, accoucher
parlante = parlant
parpadear = cligner des yeux, battre des paupières / clignoter, scintiller
parpadeo = papillotage
párpado = paupière
parroquiano,a = client(e) / paroissien(-ne)
pasaje = passage, billet, passagers
pasajero,a = passager, passant
pasamano = galon / main courante
pasar = passer, traverser, transpercer
pasillo = couloir
pasto = paturage, pature
pastoso = pateux
patán = plouc, goujat, idiot, paysan
patada = coup de pied
patear = donner des coups de pieds / piétiner / siffler, huer / laver la tête, passer un savon / trépigner, taper des pieds
patente = manifeste / brevet, patente, plaque, immatriculation
pátina = patine
patinar = patiner / déraper / gaffer
pautar = régler, rayer / tracer des portées sur (mus.)
pavor = panique, effroi, épouvante
payaso = clown
payo,a = paysan / villageois, campagnard
peana = socle
pecoso,a = criblé de tâches de rousseur
pedazo = morceau
pedido = commande
pedir = demander, exiger, commander
pedir de boca (a) = merveille (à), parfaitement, roulettes (comme sur des)
pedrada = coup de pierre
pedradas (a) = coups de pierres (à)
pedregoso = caillouteux, rocailleux
pegar (vtr) = coller / frapper, battre, donner, coller / poser / passer / pousser
pegar (vi) = prendre / aller / toucher / heurter / taper
peine = peigne
pelar = tondre, peler, éplucher, plumer
peldaño = marche, degré, échelon
pelear = se battre, se disputer
pellejo = peau
pelliza = pelisse / dolman
pelota = ballon, balle, boule / lèche-bottes
pelotero = fabricant, ramasseur de balles
peltre = étain / alliage étain-plomb, métal blanc
penar = punir, condamner à / peiner
pendejera = ?
pendejo = poil du pubis / froussard, trouillard / crétin, andouille / dépravé
pendiente = pendant, suspendu / en suspens, courant / dépendre, être à la merci / bouche d'oreille / pente
pene = pénis
pensamiento = pensée, esprit
peñazo,a = emmerdeur, empêcheur, casse-pieds
penca = feuille charnue / raquette (nopal, agave)
peón = manœuvre, ouvrier agricole / pion
peos = ?
perdedor,a = perdant(e)
perdido,a = perdu, crade / perte, fuite
peregrinar = aller en pélerinage /voyager / errer
peregrino,a = voyageur (-euse) / bizarre, drôle, étrange
pereza = paresse
pericia = dextérité, adresse, habileté, savoir-faire
perilla = bouc (barbe) / point nommé (à)
perito = expert, ingénieur technique
perjuicio = préjudice, tort, atteinte, perte
perol = marmitte
perorar = prononcer un discours / pérorer
perra = colère / no tener una perra = ne pas avoir un rond
perro,a = chien(ne)
perruno = canin
perseguir = poursuivre, rechercher
pertrechar = équiper, munir / préparer
pertrechos = attirail / équipement
pesadez = lourdeur, ennui
pesadilla = cauchemar
pesadumbre = chagrin / ennui, tracas
pesar (a pesar de) = malgré
pesaroso,a = peiné, désolé
pesimamente = très mal
pésimo,a = très mauvais
pesquería = pêche / pêcherie
pesquisa = recherche, enquête
petición = demande, pétition
petición de (a) = demande de (à la)
pétreo = pierreux
petulancia = insolence, arrogance
pezón = mamelon / queue (botanique)
piadoso,a = pieux
picadura = piqûre / morsure / début de carie
picapleitos = avocaillon
picaro,a = coquin, malin, filou, fripon, chapardeur
pico = bec, coin, pointe, pic
piélago = haute mer
pierna = jambe / patte / cuisse / gigot
pila = pile / évier, bénitier
pilleria = bande de vauriens, canaillerie, friponnerie
pinaza = aiguille
pino = pin
piñazo -> peñazo ?
piñazo -> pinaza ?
pintarrajear = barbouiller
pisada = pas / empreinte, trace / écraser le pied, écraser
pisar = marcher sur, appuyer sur / fouler / mettre les pieds à / souffler, enlever / humilier, rabaisser
pisotear = piétiner, bafouer
pita = Agave / fibre d'agave / bille
pitar = siffler / arbitrer / tirer sur
pito = sifflet, bec, cigarette, zizi, quequette
pitonisa = voyante
pizarra = ardoise / tableau
placentero = agréable, plaisant
plagado,a = infesté / rempli
plana = face, page, une / plaine / truelle / état-major
plano = plat / plan
planta = plante / usine / étage / allure, apparence
plantar = planter / plaquer, larguer / mettre, poser
plantarse = se coucher / faire face, tenir tête, refuser
plantilla = semelle / personnel (employé)
plata = argent / argentrerie
platanal = bananeraie
plateado = argenté
plazoleta = petite place
plebeyo,a = plébéien / personne vulgaire
plegar = plier
pletórico = plein (de)
pliegue = pli (document)
plomo = plomb / casse-pieds, assommant
podar = élaguer, tailler
poder = savoir / pouvoir, supporter, tenir
poderoso,a = puissant(e)
podrido,a = pourri, avarié, putride, corrompu
poltrona = bergère
polvo = poussière
pólvora = poudre
polvoriento = poussiéreux
pómulo = pommette
ponencia = conférence, exposé, communication, rapport
pordiosero,a = mendiant
pormenor = détail
portada = couverture, une (journal, revue) / façade
portañuela = 
portar/se = porter / se comporter
portátil = portatif, portable
portón = grande porte
pose = pose, attitude
poseer = posséder
poseían -> poseer
postrar = incapaciter
postrarse = se prosterner
postre = dessert
postre (para) = pour couronner le tout, par dessus le marché
postrer = dernier, ultime
postrimerías = fin
postrimero,a = dernier, dernière
potencia = puissance
potentizado = ?
potestad = puissance
pozo = puits / défausse, pile, tas
pozuelo = petit puits / jarre
pradera = prairie
prado = pré, pâturage / gazon, pelouse
prebenda = prébende / planque, sinécure / privilège, passe-droit
predilecto = préféré, de prédilection
predio = propriété foncière
pregonar = proclamer, rendre public, crier sur les toits, divulguer
prejuicio = préjugé
premiar = récompenser
prenda = vêtement / drôle d'oiseau, personne louche / gage
prendar = plaire, charmer
prender = attacher, accrocher / allumer
prender = prendre
prensa = presse
prensar = presser
prepotente = arrogant / tout-puissant
presa = proie / barrage
prescindir = se passer (de) / faire abstraction (de)
preso,a = emprisonné
prestado = prêté / emprunté / précaire
presunto,a = présumé(e)
prima = prime / chanterelle
primigenio = primitif
primo,a = cousin(e) / poire (se faire avoir)
primorosamente = ?
primoroso,a = ravissant, exquis / habile
prisa = hâte
proa = proue / nez
probar = prouver, essayer, gouter
proeza = prouesse
profesar = professer / faire preuve de / pratiquer / prononcer ses vœux
profeta = prophète
prófugo,a = fugitif / déserteur
profuso = abondant, profus
propenso,a = sujet, enclin à
propiciar = apaiser / favoriser
propósito = intention, but / approprié, propos (à)
prosapia = lignée
prosequir = poursuivre, continuer
prosopopeya = prosopopée / affection
provecho = profit / efficacité
proveedor = fournisseur
provisto,a = pourvu
proyectar = projeter
proyecto = projet
prueba = preuve / épreuve / essai / analyse
pudiendo -> poder
pues = alors / parce que, car
puesta = bien habillé / mise / ponte
pugna = lutte, bataille, bagarre, dispute
pugnar = se battre / insister
pujante = solide, robuste, dynamique
pulga = puce / tener malas pulgas = avoir mauvais caractère
pulimentar = polir
pulsera = bracelet
puñado = poignée, quelques
puño = poing, poignet, poignée, manchette
punzada = piqûre / élancement (douleur)
punzante = pointu / lancinant / caustique
putear = faire chier, faire une vacherie

Q
quebrar = casser, briser / plier / pâlir / adoucir / faire faillite
quehacer = travail, tâche, boulot
quemado = brulé, grillé
quemar = brûler / fondre / griller / cuire / vendre au rabais, liquider
querer = vouloir
queso = fromage
quiebra = effondrement, rupture / faillite / fléchissement, perte, chute
quienquiera = quiconque
quimbambas = les antipodes
quimbombó = ?
quinientos = cinq cents
quiosco = kiosque
quiso -> querer
quitar = voler, prendre, enlever, oter, faire disparaitre, nettoyer
quiten -> quitar

R
racha = rafale (de vent) / vague
raer = racler, poncer / user
raido = usé, élimé
raigambre = racines, souche / tradition
raíz = racine
raíz de (a)= suite de (à la)
rancho = ranch, grange, ferme / banquet, festin / gamelle
rancio = rance / ancien / aigri, antipathique
rapar = raser
rapiña = rapine
rapiñar = barboter
raro = bizarre / rare / étrange
raro (fam.) = homo, pédé
rascar = gratter, racler
rasgar = déchirer / gratter
rasgo = trait / caractéristique / acte
rastro = trace / marché aux puces / abattoir
rato = moment
raya = raie / rayure / pli / ligne / limite / tiret
razia = razzia
reabastecer -> abastecer
reacio = réticent
rebajar = baisser, diminuer / humilier, rabaisser, descendre
rebanar = couper / trancher
rebañar = saucer / récupérer, gratter
rebeldía = révolte / contumace
rebosar = déborder
recabar = récolter, réunir, récupérer
recabar = faire valoir, revendiquer, exiger
recado = commission / message
recalar = atterrir
recelo = suspicion, méfiance / soupçon
rechazar = repousser, rejeter
recibo = réception (action) / reçu, quittance
recio = robuste, solide, fort
reclamo = réclame / appeau
reclinar = incliner
reclutar = recruter, enrôler, mobiliser
reclutamiento = recrutement
recoger = ranger
recorrer = parcourir / fouiller
recorrido = parcours, itinéraire
recortado = coupé, découpé
recortar = couper, découper / réduire
recostar = appuyer
recriminar = récriminer
redicho = chochotte, gnangnan / poseur, pédant / redit
redil = enclos
redimir = racheter / libérer
redondo = rond / catégorique / en or
reenfocar -> enfocar
referir = rapporter
refiere -> referir
refinar = raffiner / peaufiner, affiner / polir
refino = raffinage, affinage / raffiné
reflujo = reflux
refregar = frotter / narguer
refriega = rixe, bagarre, combat, échauffourée
refulgente = resplendissant
regalar = offrir / flatter
regañadientes (a) = contre-cœur (à), rechignant (en)
regañar = fâcher (se), disputer (se), fendre (se)
regar = arroser / répandre
regentar = tenir, être à la tête de, diriger / régenter
registro = registre / fouille, perquisition
regusto = arrière-gout / air
reir = rire
relámpago = éclair
relato = rapport, récit
relieve = relief / prééminent
rellano = palier / replat
rellenar = remplir, boucher / farcir
reluciente = brillant
rematadamente = complètement, totalement
rematar = achever / adjuger / liquider / tirer au but (sport)
remitir = expédier / remettre / transmettre / renvoyer à / s'apaiser, baisser
renacentista = de la Renaissance
renuente = réticent / peu enthousiaste / laborieux
reojo (de) = du coin de l'œil
repentino,a = soudain(e)
replegar = replier
repleto (de) = plein
reporte = rapport
repostar = faire le plein / s'approvisionner
requisito = condition
resaca = ressac / gueule de bois
resacoso = ?
resaltar = faire saillie / ressortir, se distinguer
resbaladizo = glissant / délicat
reseña = signalement, compte-rendu
resequedad -> sequedad ?
resplandor = éclat
restregar = frotter
retaguardía = arrière-garde / arrière
retazo = coupon / chutes de tissu / bribes, fragment, morceau
reto = défi
retraer = rétracter / se replier
retrasar = retarder / reculer, repousser / retarder de
retratar = photographier / faire le portrait de / dépeindre
retribuir = rétribuer
retroceder = reculer
retroceso = recul / aggravation
retumbar = retentir, résonner, gronder, tonner
reventar = éclater, crever / se briser / devenir fou, être furieux
reventar = mourir d'envie de / perturber, gâcher, saboter
revisar = réviser
revolver = remuer / mettre sens dessus dessous / fouiller / soulever le cœur
revoltijo = fouillis, fatras, désordre
revuelto,a = sens dessus dessous, embrouillé / troublé / instable /agité / soulevé
riachuelo = ruisseau
ribera = rive, rivage
riña = rixe
rincón = coin / recoin
rindar = ?
riñon = rein
risotada = éclat de rire
ristre = pieza de hierro de la armadura en la que se apoya la lanza
roble = chêne (rouvre) / roc
roce = frottement, frôlement / fréquentation / heurt
roce -> rozar
rociar = asperger / semer, répandre
rocio = rosée / pluie fine, fine brume
rodaja = tranche / rondelle
rodar = rouler / dégringoler / trainer, errer
rodear = entourer, cerner / faire le tour
rodilla = genoux
rodillo = rouleau / chariot
roer = ronger / manger
rogar = prier
roido = rongé -> roer
rojizo = rougeátre
romano,a = romain
rompecabezas = puzzle / casse-tête
ron = rhum
roncar = ronfler
ronco = enroué, rauque
roñoso,a = crasseux, galeux,, rouillé, pingre, radin
ropero = armoire, penderie / ouvroir
ropero,a = vendeur(-se) (de vêtements) / linger(ère)
rosal = rosier
rostro = visage
roto = cassé, déchiré, brisé, ereinté
roto = homme, femme du peuple / accroc
rotundamente = catégoriquement
rotundo,a = catégorique / total(e)
rozar = frôler / érafler / friser / toucher
rueda = roue / cercle / ronde
ruina = ruine, décombre / délabrement
ruino = ?
ruinoso,a = ruineux / en ruine
rumbo = direction / cours / route
rutina = routine

S
sabana = savane
sábana = drap
saber = savoir / connaitre / apprendre
sabiduria = savoir / sagesse
sabihondo,a = pédant(e) / grosse tête
sabrían -> saber
sabroso,a = délicieux(se), savoureux(se) / intéressant(e) / substantiel(le)
sacar = sortir / tirer / résoudre / gagner / rallonger / prendre / passer / dépasser / arracher
saciar = étancher, se rassasier, assouvir, satisfaire
saco = sac
sacudir/se = secouer, battre / chasser, se débarrasser
salao = ?
salga -> salir
salir = sortir / partir / décoller
salitre = salpêtre
saltar = sauter / bondir / rebondir
salvar = surmonter / sauver / sauvegarder, enregistrer
salvar = empêcher
salvarse = s'en sortir, échapper à
salvedad = sauf (préposition), exception
salvo,a = sauf(sauve)
sanguijuela = sangsue
santería = sainteté / magasin d'objets religieux
sartén = poêle, poêlée
sato = ?
sazón = assaisonnement
sazon (a la sazón de) = moment là (à ce)
secar = sécher / essuyer
sediento,a = assoifé / sec / avide
según = selon, après (d') / fur et à mesure que (au) / fonction de (en)
selvatico = boisé / des bois
sembrado,a = semis / semé
sembrar = semer / parsemer, couvrir
semilla = graine / semence
semita = sémite
seña = signe, consigne / adresse
sencillo = simple
sendero = sentier
sentido = sens / sincère, du fond du cœur / susceptible / conscience
sentir = sentir
sequedad = sécheresse
séquito = cour, délégation, suite / conséquence
seso = cervelle, jugeotte
sien = tempe
silbar = siffler
silbato = sifflet
sillón = fauteuil
singón = ?
sinsabor = peine, ennui, tracas
sinsabores = déboires, déconvenues, revers
siquiera = même si / au moins
ni siquiera = même pas
soberanamente = souverainement
soberbio,a = prétentieux / superbe / énorme
sobornar = soudoyer, acheter, corrompre
soborno = corruption, pot-de-vin, dessous-de-table
sobra = excédent, en trop / sobras = restes (repas)
sobrante = restant / excédent
sobre (el) = enveloppe / sachet / pieu (lit)
sobreponer = superposer
sobreponerse = surmonter / s'imposer
sobresaltado = en sursaut
sobresaltar = faire sursauter
sobrevenir = survenir
sobrevino -> sobrevenir
socarrón,a = sournois(e) / narquois(e)
socarronería = sournoiserie
socio = associé / membre / pote
soleado,a = ensoleillé
solito -> solo ?
soltarse = lacher / libérer, relacher / défaire
soltura = aisance
sonado,a = retentissant / célèbre, populaire, connu / dingue, fou, timbré
sonoro = sonore
sopapo = claque
soplar = souffler / gonfler / donner / faucher
soporte = support, soutien
sorber = boire / absorber
sorna = ton sarcastique
sortear = tirer au sort / éviter / surmonter
sosegar = calmer
sostén = soutien / soutien-gorge
sostener = soutenir / tenir / entrenir
sótano = sous-sol, cave
soterrar = enterrer, enfouir, cacher
sublevación = soulèvement
suceder = arriver, se produire / succéder à
sucedido -> suceder
sudar = suer / suinter / trempar de sueur
suelto,a = détaché / en monnaie / unité (à l') / sans consistance / lâche (nœud) / coulant, aisé / relâché / désinvolte, déluré
suelto = suelto (monnaie)
suerte = chance / sorte
sufrido = patient, endurant, non salissant
sufrir = souffrir / supporter
sugerencia = suggestion
sugerir = suggérer
sumar = additionner / s'élever à / ajouter
sumo,a = suprême / extrême, a lo sumo = tout au plus
suponer = supposer, présumer / entrainer, avoir comme conséquence
sureño,a = du sud
surtir = fournir / jaillir
suspicacia = suspicion, méfiance
sustancioso = substantiel, important / riche
susto = peur, effroi
susurrar = chuchoter, susurrer, murmurer
susurro = chuchotement, murmure

T
tabicar = cloisonner, obstruer
tabique = cloison
tabletear = claquer
tablón = planche, plan d'eau, panneau, plongeoir
taconear = marcher, faire du bruit avec ses talons
taconear = claquer / danser les claquettes
tajada = tranche / cuite (ivresse)
tajado,a = coupé / escarpé
tajar = couper
tajante = catégorique
tal vez = peut-être
tamale = ?
tamaño = pareil (adj.) / taille, importance
tampoco = non plus
tanda = tour, groupe, tâche, série, couche
tantear = sonder, tâter, tâtonner, examiner
tanteo = tâtonnement, préemption
tapa = couvercle / couverture / talon / apéritif, portion / bouchon
tapar = couvrir / bouche, fermer / cacher
tararear = fredonner, chantonner
taza = tasse, cuvette
teatino = ?
teclado = clavier
teclear = taper
teja = tuile
tejano,a = texan / en jean
tejanos = jean
tejer = tisser, tresser, tricoter
tejida = tissage, tissu
tela = tissu, toile
temblar = trembler
temblón = tremblant
temer = craindre
temido -> temer
temor = crainte, peur
templar = calmer / tremper / couper / accorder / resserrer
tendedera = ?
tendedero = étendoir
tendido = étendu, tendu
teñir = teindre / nuancer, foncer / teinter
tensar = tendre / énerver, stresser
tenso = tendu, nerveux, stressé
tentar = tenter, tester / tâter
tenue = faible, ténu / futile
terco,a = têtu, entêté, borné
terciar = mettre en travers / intervenir, interposer
ternura = tendresse, tendreté
terreno,a = terrestre / terrain, domaine
tersura = douceur
tertulia = réunion entre amis / thé / arrière-salle, cercle / orchestre
tesca = ?
testa = tête / face
testar = faire un testament
testarudo = têtu
testigo = témoin
tetilla = mamelon, tétine
tétricamente = ?
tétrico,a = lugubre
tiburón = requin
tienta = tienta (tauromachie)
tiento = prudence / perche, balancier / boire un coup
tierno,a = tendre
tildado = accentué, taxé de
timbal = timbale
timbalú = ?
tiñe -> teñir
tintinear = tinter, cliqueter, tintinnabuler
tintineo = tintement
tipo = type, nana
tira = bande, lanière / bande dessinée
tirar = jeter, lancer / abattre / tirer / étirer / renverser / gaspiller
tirarse = se jeter / s'étendre / tirer / faire un plongeon
Tiro = Tyr
tiro = tir, coup de feu / balle / portée / tirage / entrejambe / attelage / longueur / carrure / jet / trait
tirón = crampe / vol à l'arraché / dar un tirón = tirer
toalla = serviette
tobillo = cheville
tocino = lard / sauts rapides
tocino de cielo = flan andalou
tolete = tolet (nautic.) / trique
tomar = prendre, emprunter / couvrir
tomo = tome (livre)
topar = entrer en collision / tomber sur
torbellino = tourbillon
tornarse = devenir
torneo = tournoi
toro = taureau / chariot élévateur
torpeza = bêtise, maladresse, gaucherie / gaffe, impair / lourdeur
torreón = bastion, donjon, tour
tórrido = torride
tortellino = ?
tose -> toser
toser = tousser / s'en prendre à, intimider
tozudo,a = têtu
traer = apporter, amener, rapporter / causer
tragar = avaler, engloutir, pomper
trago = gorgée, verre
traicionar = trahir
traicionero,a = traitre
trámite = démarche, formalité
tramo = tronçon, pan
trampa = piège / trappe / dette
tramposo = tricheur, mauvais payeur
trance = mauvais pas / transe
transeúnte = passant / résident temporaire / intérimaire / mobile
trapacero,a = fraudeur / chicanier
traquetear = crépiter, éclater, secouer, tripoter
trasero,a = arrière, derrière
trasiego = transvasement, décuvage
trasladar = déplacer, transporter, muter, transférer
traspapelar = égarer
traspasar = transpercer, traverser, franchir
trasquilar = tondre
trasquilado = tondu, tonsure
travesura = espièglerie
trecho = trajet / tronçon, portion
tremendamente = terriblement, énormément
tremendo,a = terrible, énorme
trigueño,a = couleur miel, châtain-clair, auburn / métis, café au lait
triscar = jouer / taper des pieds, trépigner  / tordre une dent / emmêler
trizada -> trizar ?
trizar = réduire en miettes
trocar = échanger, troquer / changer, évoluer, transformer
trocar = trocart
trompada = coup donné à une toupie, marron (beigne), coup de poing, abordage, collision
trompazo = coup fort
trompear = frapper, cogner, bagarrer (se)
tronante = ?
tronar = tonner / résonner
troncho = trognon
tronco = tronc
tropezar = se heurter à / s'opposer à
tropezarse = tomber sur
tropezon = faux pas, trébuchement / morceaux de viande, de nourriture
tropiezo = incident, difficulté / écart de conduite, faux pas
tropo = trope (emploi d'un mot dans un sens figuré, composition en musique médiévale)
trozo = bout, morceau
trueno = tonnerre, détonation
truhán = truand
tumbar = mettre par terre, renverser / incliner, pencher / démolir, abattre / étourdir
tupido,a = épais, touffu
tupir = rendre dense
turbio = trouble, louche
turgencia = turgescence
turiferario = thuriféraire (ministre servant, clerc, laique)
tuzao = ?
tzatiqui -> tzatiki ? salade de comcombres au yaourt grec

U
ubicar = placer, situer
ubicuo = ubiquiste, qui a le don d'ubiquité
ufano = fier (personne) / beau (plante)
ultrajante = outrageant
umbral = seuil
uña = ongle / griffe / sabot
untar = tartiner, enduire de, étaler
urdir = ourdir

V
vaciar = vider, évider / dépouiller / mouler
vacilar = faire marcher, charrier / tituber, chanceler / hésiter
vacio = vide
vadear = franchir à gué
vaharada = bouffée
vagar = errer / flâner
vago = vague
vago = fainéant, paresseux / clochard
vaho = vapeur
vajilla = vaisselle
valedor,a = protecteur, gardien
valioso = précieux
valla = haie, clôture
valle = vallée
vallita -> valle
vanidad = vanité, arrogance
vanidoso = orgueilleux, fier / vaniteux, présomptueux / vantard, crâneur, fanfaron
vara = tige, baton, pique
varón = garçon / homme
vástago = rejet, surgeon / rejeton, descendance / tige, baguette
vejete = viellot, vieux (vieille)
vela = bougie / veille / voile
velador = qui veille / veilleur / chandelier, guéridon
veladamente = ?
velada = soirée / voilée
velada -> velar
velar = vélaire
velar = veiller / voiler
vello = duvet
vencer = vaincre / surmonter / battre / mener
vencueto = chemin scabreux, méandre, détour
vendaval = vent (violent)
vengativo,a = vindicatif
ventaja = avantage
ventanal = baie vitrée
ventanilla = vitre, fenêtre
ventoleja = ?
ventolera = bourrasque, rafale / moulin à vent / grands airs / idée saugrenue
vera = bord
veraniego = estival, d'été
verbena = bal populaire, fête de rue, kermesse, veillée
verbena = verveine
verborrea = verbiage, verbosité
verbosidad = verbosité
verja = grille
verosímil = vraisemblable, plausible
verter = renverser / verser / traduire / exprimer, débiter / se jeter (à, dans)
vesania = vésanie
vestidor = dressing
vestir = habiller / porter
viajado -> viajar
viajar = voyager
vidrio = verre, carreau
vidrioso = vitreux / épineux / glissant / fragile
vilo = en l'air, en éveil
vilorta = cerceau en bois / étançon / clématite
vinculación = lien
vincular = lier / rendre inaliénable
vínculo = lien
vindicar = venger, défendre, revendiquer
viruta = copeau
vislumbrar = entrevoir, percevoir, deviner, discerner / pressentir
víspera = veille / vêpres
víspera (en .. de) = veille de (à la)
vista = vue, yeux / regard / audience
vista -> vestir
vistazo = coup d'œil
viudo,a = veuf, veuve
vivere -> vivir ?
vivere cauto = ?
viveres = vivres, denrées
vivero = pépinière / vivier
vocecilla = ?
voladura = explosion
volar = faire sauter / voler / s'évaporer
volcar = renverser / se retourner
volver = retourner / tourner / revenir
vomitivo,a = vomitif
vuelta = tour / retour / monnaie / tournant / dos / revers

Y
yate = yacht
yugo = joug, fardeau

Z
zamarra = blouson, fourré, pelisse, peau de mouton / rustre, pirate
zambullir = plonger
zapato = chaussure
zapatuo = ?
zarpaso = ?
zarpazo = coup de griffe
zarrapastroso,a = négligé / en lambeaux / clochard
zorrillesco = ?
zozobrar = chavirer, couler, sombrer / faire du souci (se)
zumbar = bourdonner, ronfler / filer / flanquer, foutre
zumbarse a alguien = faire (se) (sexe), taper (se)
zumbón, ona = moqueur, blagueur
zueco = sabot, chaussure plate
